person_name,expense_date,payment_account,merchant_name,merchant_description_text,actual_expense_amount,budgeted_expense_amount,expense_description_text,expense_category,account_running_balance,adjusted_actual_amount,adjusted_budgeted_amount,calculation_complexity_score,calculation_type,requires_manual_review,calculation_notes,source_system,source_file,processing_timestamp,data_version,normalization_method,expense_uuid,fiscal_year,fiscal_month,fiscal_quarter,is_complex_calculation,has_allocation_adjustment,is_split_transaction,is_complete_record,data_quality_score
Ryan,2023-09-14,Mercury,Baldur's Gate 3,,84.39,84.39,Looking into overcharge possibility,,,84.39,84.39,0.00,simple,False,,expense_history_csv,Consolidated_Expense_History_20250622.csv,2025-07-18T12:32:53.413399,3.0,advanced_calculations_v3,exp_v3_000001,2023.00,9.00,3.00,False,False,False,True,60
Ryan,2023-09-23,Mercury,Walgreens,,13.10,,,,,13.10,,0.00,simple,False,,expense_history_csv,Consolidated_Expense_History_20250622.csv,2025-07-18T12:32:53.413399,3.0,advanced_calculations_v3,exp_v3_000002,2023.00,9.00,3.00,False,False,False,True,20
Ryan,2023-09-23,Mercury,Walgreens,,22.99,22.99,"Hand sanitizer, Prosecco",,,22.99,22.99,0.00,simple,False,,expense_history_csv,Consolidated_Expense_History_20250622.csv,2025-07-18T12:32:53.413399,3.0,advanced_calculations_v3,exp_v3_000003,2023.00,9.00,3.00,False,False,False,True,60
Ryan,2023-09-23,Mercury,Walgreens,,44.98,20.00,"Astroglide, Milk Thistle",,,44.98,20.00,0.00,simple,False,,expense_history_csv,Consolidated_Expense_History_20250622.csv,2025-07-18T12:32:53.413399,3.0,advanced_calculations_v3,exp_v3_000004,2023.00,9.00,3.00,False,False,False,True,60
Ryan,2023-09-24,Mercury,Walgreens,,38.88,,"Milk Thistle, Deodorant",,,38.88,,0.00,simple,False,,expense_history_csv,Consolidated_Expense_History_20250622.csv,2025-07-18T12:32:53.413399,3.0,advanced_calculations_v3,exp_v3_000005,2023.00,9.00,3.00,False,False,False,True,40
Ryan,2023-09-24,Mercury,Walgreens,,20.45,20.45,"Laundry detergent, tissue",,,20.45,20.45,0.00,simple,False,,expense_history_csv,Consolidated_Expense_History_20250622.csv,2025-07-18T12:32:53.413399,3.0,advanced_calculations_v3,exp_v3_000006,2023.00,9.00,3.00,False,False,False,True,60
Ryan,2023-09-24,Mercury,Oklahoma Toll,,11.20,22.40,100% Jordyn (2x to calculate appropriately),,,11.20,22.40,7.00,allocation_multiplier,False,Contains allocation multiplier (2x calculation); Contains allocation multiplier (2x calculation); Contains percentage allocation: 100% Jordyn; Contains percentage allocation: 100% Jordyn; Mathematical operation: (2x to calculate appropriately),expense_history_csv,Consolidated_Expense_History_20250622.csv,2025-07-18T12:32:53.413399,3.0,advanced_calculations_v3,exp_v3_000007,2023.00,9.00,3.00,True,True,False,True,60
Ryan,2023-09-09,Wells Fargo Everyday Checking x3850,Kimmyz Tatum,,56.50,56.50,,,,56.50,56.50,0.00,simple,False,,expense_history_csv,Consolidated_Expense_History_20250622.csv,2025-07-18T12:32:53.413399,3.0,advanced_calculations_v3,exp_v3_000008,2023.00,9.00,3.00,False,False,False,True,40
Ryan,2023-09-09,Wells Fargo,Tocaya,,39.86,39.86,,,,39.86,39.86,0.00,simple,False,,expense_history_csv,Consolidated_Expense_History_20250622.csv,2025-07-18T12:32:53.413399,3.0,advanced_calculations_v3,exp_v3_000009,2023.00,9.00,3.00,False,False,False,True,40
Ryan,2023-09-09,Wells Fargo,Walmart,,56.64,,,,,56.64,,0.00,simple,False,,expense_history_csv,Consolidated_Expense_History_20250622.csv,2025-07-18T12:32:53.413399,3.0,advanced_calculations_v3,exp_v3_000010,2023.00,9.00,3.00,False,False,False,True,20
Ryan,2023-09-15,Wells Fargo,CB & CB,,40.00,40.00,,,,40.00,40.00,0.00,simple,False,,expense_history_csv,Consolidated_Expense_History_20250622.csv,2025-07-18T12:32:53.413399,3.0,advanced_calculations_v3,exp_v3_000011,2023.00,9.00,3.00,False,False,False,True,40
Ryan,2023-09-15,Wells Fargo,Lings,,27.56,,,,,27.56,,0.00,simple,False,,expense_history_csv,Consolidated_Expense_History_20250622.csv,2025-07-18T12:32:53.413399,3.0,advanced_calculations_v3,exp_v3_000012,2023.00,9.00,3.00,False,False,False,True,20
Ryan,2023-09-22,Wells Fargo,NYPD Pizza,,51.81,51.81,,,,51.81,51.81,0.00,simple,False,,expense_history_csv,Consolidated_Expense_History_20250622.csv,2025-07-18T12:32:53.413399,3.0,advanced_calculations_v3,exp_v3_000013,2023.00,9.00,3.00,False,False,False,True,40
Ryan,2023-09-23,Wells Fargo,Mastro's,,170.63,170.63,"$85.31 (Birthday present portion, 2x to calculate)",,,170.63,170.63,6.00,gift_present,False,"Contains allocation multiplier (2x calculation); Contains allocation multiplier (2x calculation); Gift/present allocation: Birthday present portion; Mathematical operation: (Birthday present portion, 2x to calculate)",expense_history_csv,Consolidated_Expense_History_20250622.csv,2025-07-18T12:32:53.413399,3.0,advanced_calculations_v3,exp_v3_000014,2023.00,9.00,3.00,True,True,False,True,60
Ryan,2023-09-23,Wells Fargo,Postino,,58.29,58.29,,,,58.29,58.29,0.00,simple,False,,expense_history_csv,Consolidated_Expense_History_20250622.csv,2025-07-18T12:32:53.413399,3.0,advanced_calculations_v3,exp_v3_000015,2023.00,9.00,3.00,False,False,False,True,40
Ryan,2023-09-25,Wells Fargo,Walmart,,59.75,,,,,59.75,,0.00,simple,False,,expense_history_csv,Consolidated_Expense_History_20250622.csv,2025-07-18T12:32:53.413399,3.0,advanced_calculations_v3,exp_v3_000016,2023.00,9.00,3.00,False,False,False,True,20
Ryan,2023-09-16,Capital One Quicksilver,DoorDash,,65.59,30.00,Wine $30,,,65.59,30.00,0.00,simple,False,,expense_history_csv,Consolidated_Expense_History_20250622.csv,2025-07-18T12:32:53.413399,3.0,advanced_calculations_v3,exp_v3_000017,2023.00,9.00,3.00,False,False,False,True,60
Ryan,2023-09-18,Capital One Quicksilver,DoorDash,,21.00,,Poke Bowl,,,21.00,,0.00,simple,False,,expense_history_csv,Consolidated_Expense_History_20250622.csv,2025-07-18T12:32:53.413399,3.0,advanced_calculations_v3,exp_v3_000018,2023.00,9.00,3.00,False,False,False,True,40
Ryan,2023-09-18,Capital One Quicksilver,DoorDash,,67.50,67.50,"Groceries (Water, Wine, Waterloo, etc.)",,,67.50,67.50,1.00,simple,False,"Mathematical operation: (Water, Wine, Waterloo, etc.)",expense_history_csv,Consolidated_Expense_History_20250622.csv,2025-07-18T12:32:53.413399,3.0,advanced_calculations_v3,exp_v3_000019,2023.00,9.00,3.00,False,False,False,True,60
Ryan,2023-09-18,Capital One Quicksilver,DoorDash,,24.78,,"Gatore, Chicken Broth, etc.",,,24.78,,0.00,simple,False,,expense_history_csv,Consolidated_Expense_History_20250622.csv,2025-07-18T12:32:53.413399,3.0,advanced_calculations_v3,exp_v3_000020,2023.00,9.00,3.00,False,False,False,True,40
Ryan,2023-09-21,Capital One Quicksilver,DoorDash,,61.28,61.28,Wine & Water,,,61.28,61.28,0.00,simple,False,,expense_history_csv,Consolidated_Expense_History_20250622.csv,2025-07-18T12:32:53.413399,3.0,advanced_calculations_v3,exp_v3_000021,2023.00,9.00,3.00,False,False,False,True,60
Ryan,2023-09-27,Capital One Quicksilver,DoorDash,,53.72,53.72,"Groceries, water, etc.",,,53.72,53.72,0.00,simple,False,,expense_history_csv,Consolidated_Expense_History_20250622.csv,2025-07-18T12:32:53.413399,3.0,advanced_calculations_v3,exp_v3_000022,2023.00,9.00,3.00,False,False,False,True,60
Ryan,2023-09-23,Capital One Savor One,Fry's,,56.76,56.76,,,,56.76,56.76,0.00,simple,False,,expense_history_csv,Consolidated_Expense_History_20250622.csv,2025-07-18T12:32:53.413399,3.0,advanced_calculations_v3,exp_v3_000023,2023.00,9.00,3.00,False,False,False,True,40
Ryan,2023-09-23,Capital One Savor One,Fry's,,24.53,24.53,,,,24.53,24.53,0.00,simple,False,,expense_history_csv,Consolidated_Expense_History_20250622.csv,2025-07-18T12:32:53.413399,3.0,advanced_calculations_v3,exp_v3_000024,2023.00,9.00,3.00,False,False,False,True,40
Ryan,2023-09-26,Capital One Savor One,Fry's,,2.29,2.29,,,,2.29,2.29,0.00,simple,False,,expense_history_csv,Consolidated_Expense_History_20250622.csv,2025-07-18T12:32:53.413399,3.0,advanced_calculations_v3,exp_v3_000025,2023.00,9.00,3.00,False,False,False,True,40
Ryan,2023-09-26,Capital One Savor One,Fry's,,39.93,39.93,,,,39.93,39.93,0.00,simple,False,,expense_history_csv,Consolidated_Expense_History_20250622.csv,2025-07-18T12:32:53.413399,3.0,advanced_calculations_v3,exp_v3_000026,2023.00,9.00,3.00,False,False,False,True,40
Ryan,2023-09-09,Apple,Bro,,80.00,80.00,,,,80.00,80.00,0.00,simple,False,,expense_history_csv,Consolidated_Expense_History_20250622.csv,2025-07-18T12:32:53.413399,3.0,advanced_calculations_v3,exp_v3_000027,2023.00,9.00,3.00,False,False,False,True,40
Ryan,2023-09-11,Apple,Bro,,225.00,225.00,,,,225.00,225.00,0.00,simple,False,,expense_history_csv,Consolidated_Expense_History_20250622.csv,2025-07-18T12:32:53.413399,3.0,advanced_calculations_v3,exp_v3_000028,2023.00,9.00,3.00,False,False,False,True,40
Ryan,2023-09-17,Apple,Bro,,225.00,225.00,,,,225.00,225.00,0.00,simple,False,,expense_history_csv,Consolidated_Expense_History_20250622.csv,2025-07-18T12:32:53.413399,3.0,advanced_calculations_v3,exp_v3_000029,2023.00,9.00,3.00,False,False,False,True,40
Ryan,2023-09-24,Apple,Bro,,225.00,225.00,,,,225.00,225.00,0.00,simple,False,,expense_history_csv,Consolidated_Expense_History_20250622.csv,2025-07-18T12:32:53.413399,3.0,advanced_calculations_v3,exp_v3_000030,2023.00,9.00,3.00,False,False,False,True,40
Ryan,2023-09-28,Apple,Bro,,235.00,,,,,235.00,,0.00,simple,False,,expense_history_csv,Consolidated_Expense_History_20250622.csv,2025-07-18T12:32:53.413399,3.0,advanced_calculations_v3,exp_v3_000031,2023.00,9.00,3.00,False,False,False,True,20
Ryan,2023-09-16,Zelle,Ethan,,220.00,220.00,,,,220.00,220.00,0.00,simple,False,,expense_history_csv,Consolidated_Expense_History_20250622.csv,2025-07-18T12:32:53.413399,3.0,advanced_calculations_v3,exp_v3_000032,2023.00,9.00,3.00,False,False,False,True,40
Ryan,2023-09-29,Zelle,Francisco,,200.00,200.00,,,,200.00,200.00,0.00,simple,False,,expense_history_csv,Consolidated_Expense_History_20250622.csv,2025-07-18T12:32:53.413399,3.0,advanced_calculations_v3,exp_v3_000033,2023.00,9.00,3.00,False,False,False,True,40
Jordyn,2023-09-09,Wells Fargo,Kodo Sushi,,90.00,90.00,,,,90.00,90.00,0.00,simple,False,,expense_history_csv,Consolidated_Expense_History_20250622.csv,2025-07-18T12:32:53.413399,3.0,advanced_calculations_v3,exp_v3_000034,2023.00,9.00,3.00,False,False,False,True,40
Jordyn,2023-09-10,Wells Fargo,Taste of Gilbert,,35.81,35.81,,,,35.81,35.81,0.00,simple,False,,expense_history_csv,Consolidated_Expense_History_20250622.csv,2025-07-18T12:32:53.413399,3.0,advanced_calculations_v3,exp_v3_000035,2023.00,9.00,3.00,False,False,False,True,40
Jordyn,2023-09-11,Wells Fargo,Frys,,274.82,274.82,,,,274.82,274.82,0.00,simple,False,,expense_history_csv,Consolidated_Expense_History_20250622.csv,2025-07-18T12:32:53.413399,3.0,advanced_calculations_v3,exp_v3_000036,2023.00,9.00,3.00,False,False,False,True,40
Jordyn,2023-09-13,Wells Fargo,Whole Foods,,25.50,25.50,,,,25.50,25.50,0.00,simple,False,,expense_history_csv,Consolidated_Expense_History_20250622.csv,2025-07-18T12:32:53.413399,3.0,advanced_calculations_v3,exp_v3_000037,2023.00,9.00,3.00,False,False,False,True,40
Jordyn,2023-09-15,Wells Fargo,CB & CB,,40.00,40.00,,,,40.00,40.00,0.00,simple,False,,expense_history_csv,Consolidated_Expense_History_20250622.csv,2025-07-18T12:32:53.413399,3.0,advanced_calculations_v3,exp_v3_000038,2023.00,9.00,3.00,False,False,False,True,40
Jordyn,2023-09-18,Wells Fargo,Frys,,298.08,298.08,,,,298.08,298.08,0.00,simple,False,,expense_history_csv,Consolidated_Expense_History_20250622.csv,2025-07-18T12:32:53.413399,3.0,advanced_calculations_v3,exp_v3_000039,2023.00,9.00,3.00,False,False,False,True,40
Jordyn,2023-09-18,Wells Fargo,Lings,,35.56,,,,,35.56,,0.00,simple,False,,expense_history_csv,Consolidated_Expense_History_20250622.csv,2025-07-18T12:32:53.413399,3.0,advanced_calculations_v3,exp_v3_000040,2023.00,9.00,3.00,False,False,False,True,20
Jordyn,2023-09-19,Wells Fargo,Five Guys,,32.00,32.00,,,,32.00,32.00,0.00,simple,False,,expense_history_csv,Consolidated_Expense_History_20250622.csv,2025-07-18T12:32:53.413399,3.0,advanced_calculations_v3,exp_v3_000041,2023.00,9.00,3.00,False,False,False,True,40
Jordyn,2023-09-20,Wells Fargo,Sprouts,,49.42,49.42,,,,49.42,49.42,0.00,simple,False,,expense_history_csv,Consolidated_Expense_History_20250622.csv,2025-07-18T12:32:53.413399,3.0,advanced_calculations_v3,exp_v3_000042,2023.00,9.00,3.00,False,False,False,True,40
Jordyn,2023-09-25,Wells Fargo,Frys,,271.10,271.10,,,,271.10,271.10,0.00,simple,False,,expense_history_csv,Consolidated_Expense_History_20250622.csv,2025-07-18T12:32:53.413399,3.0,advanced_calculations_v3,exp_v3_000043,2023.00,9.00,3.00,False,False,False,True,40
Jordyn,2023-09-24,Wells Fargo,Tixr,,201.22,201.22,,,,201.22,201.22,0.00,simple,False,,expense_history_csv,Consolidated_Expense_History_20250622.csv,2025-07-18T12:32:53.413399,3.0,advanced_calculations_v3,exp_v3_000044,2023.00,9.00,3.00,False,False,False,True,40
Ryan,2023-09-24,Mercury,Walgreens,,18.70,18.70,"Tide, Arm & Hammer, Puff",,,18.70,18.70,0.00,simple,False,,expense_history_csv,Consolidated_Expense_History_20250622.csv,2025-07-18T12:32:53.413399,3.0,advanced_calculations_v3,exp_v3_000045,2023.00,9.00,3.00,False,False,False,True,60
Ryan,2023-09-24,Mercury,Walgreens,,32.88,,"MIlk Thistle, Deodorant",,,32.88,,0.00,simple,False,,expense_history_csv,Consolidated_Expense_History_20250622.csv,2025-07-18T12:32:53.413399,3.0,advanced_calculations_v3,exp_v3_000046,2023.00,9.00,3.00,False,False,False,True,40
Ryan,2023-09-24,Mercury,Oklahoma Tolls,,11.20,22.40,Jordyn Tolls,,,11.20,22.40,0.00,simple,False,,expense_history_csv,Consolidated_Expense_History_20250622.csv,2025-07-18T12:32:53.413399,3.0,advanced_calculations_v3,exp_v3_000047,2023.00,9.00,3.00,False,False,False,True,60
Ryan,2023-09-27,Mercury,Amazon,,23.61,,3 Ring Binder,,,23.61,,0.00,simple,False,,expense_history_csv,Consolidated_Expense_History_20250622.csv,2025-07-18T12:32:53.413399,3.0,advanced_calculations_v3,exp_v3_000048,2023.00,9.00,3.00,False,False,False,True,40
Ryan,2023-09-28,Mercury,Amazon,,47.97,,"CoQ10, Flaxseed",,,47.97,,0.00,simple,False,,expense_history_csv,Consolidated_Expense_History_20250622.csv,2025-07-18T12:32:53.413399,3.0,advanced_calculations_v3,exp_v3_000049,2023.00,9.00,3.00,False,False,False,True,40
Ryan,2023-09-28,Mercury,Amazon,,21.58,,L-Theanine,,,21.58,,0.00,simple,False,,expense_history_csv,Consolidated_Expense_History_20250622.csv,2025-07-18T12:32:53.413399,3.0,advanced_calculations_v3,exp_v3_000050,2023.00,9.00,3.00,False,False,False,True,40
Ryan,2023-09-30,Mercury,Amazon,,13.10,,Refund,,,13.10,,0.00,simple,False,,expense_history_csv,Consolidated_Expense_History_20250622.csv,2025-07-18T12:32:53.413399,3.0,advanced_calculations_v3,exp_v3_000051,2023.00,9.00,3.00,False,False,False,True,40
Ryan,2023-10-02,Mercury,Amazon,,11.87,11.87,Rapid Strips,,,11.87,11.87,0.00,simple,False,,expense_history_csv,Consolidated_Expense_History_20250622.csv,2025-07-18T12:32:53.413399,3.0,advanced_calculations_v3,exp_v3_000052,2023.00,10.00,4.00,False,False,False,True,60
Ryan,2023-10-03,Mercury,Public Storage,,125.46,,Itemized on Monthly Budget,,,125.46,,0.00,simple,False,,expense_history_csv,Consolidated_Expense_History_20250622.csv,2025-07-18T12:32:53.413399,3.0,advanced_calculations_v3,exp_v3_000053,2023.00,10.00,4.00,False,False,False,True,40
Ryan,2023-10-03,Mercury,Amazon,,22.57,,Tests,,,22.57,,0.00,simple,False,,expense_history_csv,Consolidated_Expense_History_20250622.csv,2025-07-18T12:32:53.413399,3.0,advanced_calculations_v3,exp_v3_000054,2023.00,10.00,4.00,False,False,False,True,40
Ryan,2023-10-10,Mercury,Amazon,,86.39,,Refund,,,86.39,,0.00,simple,False,,expense_history_csv,Consolidated_Expense_History_20250622.csv,2025-07-18T12:32:53.413399,3.0,advanced_calculations_v3,exp_v3_000055,2023.00,10.00,4.00,False,False,False,True,40
Ryan,2023-10-13,Mercury,Amazon,,150.00,,Refund,,,150.00,,0.00,simple,False,,expense_history_csv,Consolidated_Expense_History_20250622.csv,2025-07-18T12:32:53.413399,3.0,advanced_calculations_v3,exp_v3_000056,2023.00,10.00,4.00,False,False,False,True,40
Ryan,2023-10-13,Mercury,Amazon,,50.00,,Refund,,,50.00,,0.00,simple,False,,expense_history_csv,Consolidated_Expense_History_20250622.csv,2025-07-18T12:32:53.413399,3.0,advanced_calculations_v3,exp_v3_000057,2023.00,10.00,4.00,False,False,False,True,40
Ryan,2023-10-13,Mercury,Walmart,,34.46,34.46,Ink,,,34.46,34.46,0.00,simple,False,,expense_history_csv,Consolidated_Expense_History_20250622.csv,2025-07-18T12:32:53.413399,3.0,advanced_calculations_v3,exp_v3_000058,2023.00,10.00,4.00,False,False,False,True,60
Ryan,2023-10-17,Mercury,Amazon,,1185.30,600.00,TV,,,1185.30,600.00,0.00,simple,False,,expense_history_csv,Consolidated_Expense_History_20250622.csv,2025-07-18T12:32:53.413399,3.0,advanced_calculations_v3,exp_v3_000059,2023.00,10.00,4.00,False,False,False,True,60
Ryan,2023-10-18,Mercury,Amazon,,5.93,,Brush,,,5.93,,0.00,simple,False,,expense_history_csv,Consolidated_Expense_History_20250622.csv,2025-07-18T12:32:53.413399,3.0,advanced_calculations_v3,exp_v3_000060,2023.00,10.00,4.00,False,False,False,True,40
Ryan,2023-10-18,Mercury,Amazon,,15.55,,Retainer Brite Tablets,,,15.55,,0.00,simple,False,,expense_history_csv,Consolidated_Expense_History_20250622.csv,2025-07-18T12:32:53.413399,3.0,advanced_calculations_v3,exp_v3_000061,2023.00,10.00,4.00,False,False,False,True,40
Ryan,2023-10-18,Mercury,Amazon,,22.46,,Mouthwash,,,22.46,,0.00,simple,False,,expense_history_csv,Consolidated_Expense_History_20250622.csv,2025-07-18T12:32:53.413399,3.0,advanced_calculations_v3,exp_v3_000062,2023.00,10.00,4.00,False,False,False,True,40
Ryan,2023-10-01,Wells Fargo,Koi Poke,,52.60,52.60,,,,52.60,52.60,0.00,simple,False,,expense_history_csv,Consolidated_Expense_History_20250622.csv,2025-07-18T12:32:53.413399,3.0,advanced_calculations_v3,exp_v3_000063,2023.00,10.00,4.00,False,False,False,True,40
Ryan,2023-10-09,Wells Fargo,Tocaya,,39.85,39.85,,,,39.85,39.85,0.00,simple,False,,expense_history_csv,Consolidated_Expense_History_20250622.csv,2025-07-18T12:32:53.413399,3.0,advanced_calculations_v3,exp_v3_000064,2023.00,10.00,4.00,False,False,False,True,40
Ryan,2023-10-12,Wells Fargo,Walmart,,50.10,,Gas,,,50.10,,0.00,simple,False,,expense_history_csv,Consolidated_Expense_History_20250622.csv,2025-07-18T12:32:53.413399,3.0,advanced_calculations_v3,exp_v3_000065,2023.00,10.00,4.00,False,False,False,True,40
Ryan,2023-10-14,Wells Fargo,Trader Joe's,,32.38,32.38,,,,32.38,32.38,0.00,simple,False,,expense_history_csv,Consolidated_Expense_History_20250622.csv,2025-07-18T12:32:53.413399,3.0,advanced_calculations_v3,exp_v3_000066,2023.00,10.00,4.00,False,False,False,True,40
Ryan,2023-09-23,Capital One Quiksilver,DoorDash,,61.28,,Water & Wine,,,61.28,,0.00,simple,False,,expense_history_csv,Consolidated_Expense_History_20250622.csv,2025-07-18T12:32:53.413399,3.0,advanced_calculations_v3,exp_v3_000067,2023.00,9.00,3.00,False,False,False,True,40
Ryan,2023-10-14,Capital One Quiksilver,DoorDash,,48.56,48.56,Water & Tito's,,,48.56,48.56,0.00,simple,False,,expense_history_csv,Consolidated_Expense_History_20250622.csv,2025-07-18T12:32:53.413399,3.0,advanced_calculations_v3,exp_v3_000068,2023.00,10.00,4.00,False,False,False,True,60
Ryan,2023-10-16,Capital One Quiksilver,DoorDash,,18.01,,CB & CB,,,18.01,,0.00,simple,False,,expense_history_csv,Consolidated_Expense_History_20250622.csv,2025-07-18T12:32:53.413399,3.0,advanced_calculations_v3,exp_v3_000069,2023.00,10.00,4.00,False,False,False,True,40
Ryan,2023-09-30,Capital One Savor One,Fry's,,43.40,43.40,Wine,,,43.40,43.40,0.00,simple,False,,expense_history_csv,Consolidated_Expense_History_20250622.csv,2025-07-18T12:32:53.413399,3.0,advanced_calculations_v3,exp_v3_000070,2023.00,9.00,3.00,False,False,False,True,60
Ryan,2023-10-06,Capital One Savor One,Fry's,,14.33,,"10/04 Order (Split $14.33 2463 / $29.06 EBT) Oikos, Beef Jerky, Sponges and Water",,,14.33,,4.00,split_transaction,False,Mathematical operation: 10/04; Mathematical operation: (Split $14.33 2463 / $29.06 EBT); Split transaction: Split $14.33 2463 / $29.06 EBT,expense_history_csv,Consolidated_Expense_History_20250622.csv,2025-07-18T12:32:53.413399,3.0,advanced_calculations_v3,exp_v3_000071,2023.00,10.00,4.00,True,False,True,True,40
Ryan,2023-10-06,Capital One Savor One,Fry's,,11.09,11.09,3 Seltzers,,,11.09,11.09,0.00,simple,False,,expense_history_csv,Consolidated_Expense_History_20250622.csv,2025-07-18T12:32:53.413399,3.0,advanced_calculations_v3,exp_v3_000072,2023.00,10.00,4.00,False,False,False,True,60
Ryan,2023-10-11,Capital One Savor One,Fry's,,139.49,139.49,10/09 Order (Split $139.49 2463 / $76.25 EBT),,,139.49,139.49,4.00,split_transaction,False,Mathematical operation: 10/09; Mathematical operation: (Split $139.49 2463 / $76.25 EBT); Split transaction: Split $139.49 2463 / $76.25 EBT,expense_history_csv,Consolidated_Expense_History_20250622.csv,2025-07-18T12:32:53.413399,3.0,advanced_calculations_v3,exp_v3_000073,2023.00,10.00,4.00,True,False,True,True,60
Ryan,2023-10-17,Capital One Savor One,Fry's,,22.16,,Sushi,,,22.16,,0.00,simple,False,,expense_history_csv,Consolidated_Expense_History_20250622.csv,2025-07-18T12:32:53.413399,3.0,advanced_calculations_v3,exp_v3_000074,2023.00,10.00,4.00,False,False,False,True,40
Ryan,2023-10-01,EBT,Fry's,,147.66,147.66,10/01 Order,,,147.66,147.66,1.00,simple,False,Mathematical operation: 10/01,expense_history_csv,Consolidated_Expense_History_20250622.csv,2025-07-18T12:32:53.413399,3.0,advanced_calculations_v3,exp_v3_000075,2023.00,10.00,4.00,False,False,False,True,60
Ryan,2023-10-01,EBT,Fry's,,39.30,39.30,"10/01 Order Amendment - Chicken tender, Pizza, Luna Bars",,,39.30,39.30,1.00,simple,False,Mathematical operation: 10/01,expense_history_csv,Consolidated_Expense_History_20250622.csv,2025-07-18T12:32:53.413399,3.0,advanced_calculations_v3,exp_v3_000076,2023.00,10.00,4.00,False,False,False,True,60
Ryan,2023-10-04,EBT,Fry's,,29.06,29.06,"10/04 Order (Split $14.33 2463 / $29.06 EBT) Oikos, Beef Jerky, Sponges and Water",,,29.06,29.06,4.00,split_transaction,False,Mathematical operation: 10/04; Mathematical operation: (Split $14.33 2463 / $29.06 EBT); Split transaction: Split $14.33 2463 / $29.06 EBT,expense_history_csv,Consolidated_Expense_History_20250622.csv,2025-07-18T12:32:53.413399,3.0,advanced_calculations_v3,exp_v3_000077,2023.00,10.00,4.00,True,False,True,True,60
Ryan,2023-10-09,EBT,Fry's,,76.27,76.27,10/09 Order (Split $139.49 2463 / $76.25 EBT),,,76.27,76.27,4.00,split_transaction,False,Mathematical operation: 10/09; Mathematical operation: (Split $139.49 2463 / $76.25 EBT); Split transaction: Split $139.49 2463 / $76.25 EBT,expense_history_csv,Consolidated_Expense_History_20250622.csv,2025-07-18T12:32:53.413399,3.0,advanced_calculations_v3,exp_v3_000078,2023.00,10.00,4.00,True,False,True,True,60
Ryan,2023-10-16,EBT,Fry's,,177.03,177.03,10/16 Order (Split $138.76 4296 / 177.03 EBT),,,177.03,177.03,5.00,split_transaction,False,Mathematical operation: 10/16; Mathematical operation: 4296 / 177.03; Mathematical operation: (Split $138.76 4296 / 177.03 EBT); Split transaction: Split $138.76 4296 / 177.03 EBT,expense_history_csv,Consolidated_Expense_History_20250622.csv,2025-07-18T12:32:53.413399,3.0,advanced_calculations_v3,exp_v3_000079,2023.00,10.00,4.00,True,False,True,True,60
Ryan,2023-10-06,Apple,Bro,,225.00,225.00,,,,225.00,225.00,0.00,simple,False,,expense_history_csv,Consolidated_Expense_History_20250622.csv,2025-07-18T12:32:53.413399,3.0,advanced_calculations_v3,exp_v3_000080,2023.00,10.00,4.00,False,False,False,True,40
Ryan,2023-10-02,Wells Fargo Checking,Ethan,,220.00,220.00,,,,220.00,220.00,0.00,simple,False,,expense_history_csv,Consolidated_Expense_History_20250622.csv,2025-07-18T12:32:53.413399,3.0,advanced_calculations_v3,exp_v3_000081,2023.00,10.00,4.00,False,False,False,True,40
Ryan,2023-10-11,Wells Fargo Checking,Bro,,225.00,225.00,,,,225.00,225.00,0.00,simple,False,,expense_history_csv,Consolidated_Expense_History_20250622.csv,2025-07-18T12:32:53.413399,3.0,advanced_calculations_v3,exp_v3_000082,2023.00,10.00,4.00,False,False,False,True,40
Ryan,2023-10-16,Wells Fargo Checking,Bro,,220.00,220.00,,,,220.00,220.00,0.00,simple,False,,expense_history_csv,Consolidated_Expense_History_20250622.csv,2025-07-18T12:32:53.413399,3.0,advanced_calculations_v3,exp_v3_000083,2023.00,10.00,4.00,False,False,False,True,40
Ryan,2023-10-16,Wells Fargo Checking,Ethan,,380.00,380.00,,,,380.00,380.00,0.00,simple,False,,expense_history_csv,Consolidated_Expense_History_20250622.csv,2025-07-18T12:32:53.413399,3.0,advanced_calculations_v3,exp_v3_000084,2023.00,10.00,4.00,False,False,False,True,40
Jordyn,2023-10-01,Wells Fargo,Fry's,,133.78,133.78,,,,133.78,133.78,0.00,simple,False,,expense_history_csv,Consolidated_Expense_History_20250622.csv,2025-07-18T12:32:53.413399,3.0,advanced_calculations_v3,exp_v3_000085,2023.00,10.00,4.00,False,False,False,True,40
Jordyn,2023-10-01,Wells Fargo,,,1.75,1.75,,,,1.75,1.75,0.00,simple,False,,expense_history_csv,Consolidated_Expense_History_20250622.csv,2025-07-18T12:32:53.413399,3.0,advanced_calculations_v3,exp_v3_000086,2023.00,10.00,4.00,False,False,False,True,40
Jordyn,2023-10-01,Wells Fargo,Ling's,,77.16,77.16,,,,77.16,77.16,0.00,simple,False,,expense_history_csv,Consolidated_Expense_History_20250622.csv,2025-07-18T12:32:53.413399,3.0,advanced_calculations_v3,exp_v3_000087,2023.00,10.00,4.00,False,False,False,True,40
Jordyn,2023-10-04,Wells Fargo,A R I Z O N A,,96.00,96.00,,,,96.00,96.00,0.00,simple,False,,expense_history_csv,Consolidated_Expense_History_20250622.csv,2025-07-18T12:32:53.413399,3.0,advanced_calculations_v3,exp_v3_000088,2023.00,10.00,4.00,False,False,False,True,40
Jordyn,2023-10-07,Wells Fargo,Intentional Foods,,46.30,46.30,,,,46.30,46.30,0.00,simple,False,,expense_history_csv,Consolidated_Expense_History_20250622.csv,2025-07-18T12:32:53.413399,3.0,advanced_calculations_v3,exp_v3_000089,2023.00,10.00,4.00,False,False,False,True,40
Jordyn,2023-10-07,Wells Fargo,Fry's,,15.43,15.43,,,,15.43,15.43,0.00,simple,False,,expense_history_csv,Consolidated_Expense_History_20250622.csv,2025-07-18T12:32:53.413399,3.0,advanced_calculations_v3,exp_v3_000090,2023.00,10.00,4.00,False,False,False,True,40
Jordyn,2023-10-09,Wells Fargo,Fry's,,29.05,29.05,,,,29.05,29.05,0.00,simple,False,,expense_history_csv,Consolidated_Expense_History_20250622.csv,2025-07-18T12:32:53.413399,3.0,advanced_calculations_v3,exp_v3_000091,2023.00,10.00,4.00,False,False,False,True,40
Jordyn,2023-10-16,Wells Fargo,Fry's,,138.76,138.76,,,,138.76,138.76,0.00,simple,False,,expense_history_csv,Consolidated_Expense_History_20250622.csv,2025-07-18T12:32:53.413399,3.0,advanced_calculations_v3,exp_v3_000092,2023.00,10.00,4.00,False,False,False,True,40
Jordyn,2023-10-18,Wells Fargo,Bashas,,26.17,26.17,,,,26.17,26.17,0.00,simple,False,,expense_history_csv,Consolidated_Expense_History_20250622.csv,2025-07-18T12:32:53.413399,3.0,advanced_calculations_v3,exp_v3_000093,2023.00,10.00,4.00,False,False,False,True,40
Jordyn,2023-10-11,Wells Fargo,Amazon,,144.00,144.00,Vacuum & Brita,,,144.00,144.00,0.00,simple,False,,expense_history_csv,Consolidated_Expense_History_20250622.csv,2025-07-18T12:32:53.413399,3.0,advanced_calculations_v3,exp_v3_000094,2023.00,10.00,4.00,False,False,False,True,60
Jordyn,2023-10-11,Wells Fargo,Amazon,,320.00,322.00,"Pans, Charger, Kindle, etc.",,,320.00,322.00,0.00,simple,False,,expense_history_csv,Consolidated_Expense_History_20250622.csv,2025-07-18T12:32:53.413399,3.0,advanced_calculations_v3,exp_v3_000095,2023.00,10.00,4.00,False,False,False,True,60
Jordyn,,Wells Fargo,Amazon,,15.00,15.00,Simple Mills (Amazon),,,15.00,15.00,1.00,simple,False,Mathematical operation: (Amazon),expense_history_csv,Consolidated_Expense_History_20250622.csv,2025-07-18T12:32:53.413399,3.0,advanced_calculations_v3,exp_v3_000096,,,,False,False,False,False,20
Ryan,2023-10-19,Mercury,Prime Video,,3.15,3.15,Curiosty Stream?,,,3.15,3.15,0.00,simple,False,,expense_history_csv,Consolidated_Expense_History_20250622.csv,2025-07-18T12:32:53.413399,3.0,advanced_calculations_v3,exp_v3_000097,2023.00,10.00,4.00,False,False,False,True,60
Ryan,2023-10-21,Mercury,Amazon,,21.60,,Iron Man Shirt,,,21.60,,0.00,simple,False,,expense_history_csv,Consolidated_Expense_History_20250622.csv,2025-07-18T12:32:53.413399,3.0,advanced_calculations_v3,exp_v3_000098,2023.00,10.00,4.00,False,False,False,True,40
Ryan,2023-10-21,Mercury,Walmart,,50.43,50.43,"Luna bar, Band-Aid, Lunch Meat & Tito's",,,50.43,50.43,0.00,simple,False,,expense_history_csv,Consolidated_Expense_History_20250622.csv,2025-07-18T12:32:53.413399,3.0,advanced_calculations_v3,exp_v3_000099,2023.00,10.00,4.00,False,False,False,True,60
Ryan,2023-10-22,Mercury,Amazon,,20.52,,Iron Man Shirt,,,20.52,,0.00,simple,False,,expense_history_csv,Consolidated_Expense_History_20250622.csv,2025-07-18T12:32:53.413399,3.0,advanced_calculations_v3,exp_v3_000100,2023.00,10.00,4.00,False,False,False,True,40
Ryan,2023-10-26,Mercury,Amazon,,14.04,14.04,LED Puck Lights,,,14.04,14.04,0.00,simple,False,,expense_history_csv,Consolidated_Expense_History_20250622.csv,2025-07-18T12:32:53.413399,3.0,advanced_calculations_v3,exp_v3_000101,2023.00,10.00,4.00,False,False,False,True,60
Ryan,2023-10-26,Mercury,Amazon,,21.11,,Hulk Shirt,,,21.11,,0.00,simple,False,,expense_history_csv,Consolidated_Expense_History_20250622.csv,2025-07-18T12:32:53.413399,3.0,advanced_calculations_v3,exp_v3_000102,2023.00,10.00,4.00,False,False,False,True,40
Ryan,2023-10-27,Mercury,Amazon,,18.97,,Ear Plugs,,,18.97,,0.00,simple,False,,expense_history_csv,Consolidated_Expense_History_20250622.csv,2025-07-18T12:32:53.413399,3.0,advanced_calculations_v3,exp_v3_000103,2023.00,10.00,4.00,False,False,False,True,40
Ryan,2023-10-27,Mercury,Amazon,,18.34,,"""Pepper Shaker"" :)",,,18.34,,0.00,simple,False,,expense_history_csv,Consolidated_Expense_History_20250622.csv,2025-07-18T12:32:53.413399,3.0,advanced_calculations_v3,exp_v3_000104,2023.00,10.00,4.00,False,False,False,True,40
Ryan,2023-10-30,Mercury,Manuel's,,75.46,75.46,,,,75.46,75.46,0.00,simple,False,,expense_history_csv,Consolidated_Expense_History_20250622.csv,2025-07-18T12:32:53.413399,3.0,advanced_calculations_v3,exp_v3_000105,2023.00,10.00,4.00,False,False,False,True,40
Ryan,2023-11-01,Mercury,Amazon,,50.50,,"Eyeglass cleaner, soap dispenser",,,50.50,,0.00,simple,False,,expense_history_csv,Consolidated_Expense_History_20250622.csv,2025-07-18T12:32:53.413399,3.0,advanced_calculations_v3,exp_v3_000106,2023.00,11.00,4.00,False,False,False,True,40
Ryan,2023-11-01,Mercury,Amazon,,63.54,,"Supplements, headlamp",,,63.54,,0.00,simple,False,,expense_history_csv,Consolidated_Expense_History_20250622.csv,2025-07-18T12:32:53.413399,3.0,advanced_calculations_v3,exp_v3_000107,2023.00,11.00,4.00,False,False,False,True,40
Ryan,2023-10-16,Capital One Quiksilver,DoorDash,,51.56,51.56,"Missed - Josh Cab, Vinegar, New Zealand Sauvignon Blanc, Sparkling Watermelon, Polar Lime",,,51.56,51.56,0.00,simple,False,,expense_history_csv,Consolidated_Expense_History_20250622.csv,2025-07-18T12:32:53.413399,3.0,advanced_calculations_v3,exp_v3_000108,2023.00,10.00,4.00,False,False,False,True,60
Ryan,2023-11-06,Capital One Quiksilver,DoorDash,,21.79,,CB & CB,,,21.79,,0.00,simple,False,,expense_history_csv,Consolidated_Expense_History_20250622.csv,2025-07-18T12:32:53.413399,3.0,advanced_calculations_v3,exp_v3_000109,2023.00,11.00,4.00,False,False,False,True,40
Ryan,2023-11-06,Capital One Quiksilver,DoorDash,,25.99,,Koibito Poke,,,25.99,,0.00,simple,False,,expense_history_csv,Consolidated_Expense_History_20250622.csv,2025-07-18T12:32:53.413399,3.0,advanced_calculations_v3,exp_v3_000110,2023.00,11.00,4.00,False,False,False,True,40
Ryan,2023-11-06,Capital One Quiksilver,DoorDash,,45.85,45.85,"Wine, Pho Rice Noodles",,,45.85,45.85,0.00,simple,False,,expense_history_csv,Consolidated_Expense_History_20250622.csv,2025-07-18T12:32:53.413399,3.0,advanced_calculations_v3,exp_v3_000111,2023.00,11.00,4.00,False,False,False,True,60
Ryan,2023-11-01,Capital One Savor One,Fry's,,56.46,,Stephanie,,,56.46,,0.00,simple,False,,expense_history_csv,Consolidated_Expense_History_20250622.csv,2025-07-18T12:32:53.413399,3.0,advanced_calculations_v3,exp_v3_000112,2023.00,11.00,4.00,False,False,False,True,40
Ryan,2023-10-22,EBT,Fry's,,113.97,113.97,,,,113.97,113.97,0.00,simple,False,,expense_history_csv,Consolidated_Expense_History_20250622.csv,2025-07-18T12:32:53.413399,3.0,advanced_calculations_v3,exp_v3_000113,2023.00,10.00,4.00,False,False,False,True,40
Ryan,2023-10-21,Wells Fargo Autograph,Kodo,,69.35,69.35,,,,69.35,69.35,0.00,simple,False,,expense_history_csv,Consolidated_Expense_History_20250622.csv,2025-07-18T12:32:53.413399,3.0,advanced_calculations_v3,exp_v3_000114,2023.00,10.00,4.00,False,False,False,True,40
Ryan,2023-10-23,Wells Fargo Autograph,Hopdoddy,,49.65,49.65,,,,49.65,49.65,0.00,simple,False,,expense_history_csv,Consolidated_Expense_History_20250622.csv,2025-07-18T12:32:53.413399,3.0,advanced_calculations_v3,exp_v3_000115,2023.00,10.00,4.00,False,False,False,True,40
Ryan,2023-10-23,Wells Fargo Autograph,Walmart,,39.23,,"What was this, no record online?",,,39.23,,0.00,simple,False,,expense_history_csv,Consolidated_Expense_History_20250622.csv,2025-07-18T12:32:53.413399,3.0,advanced_calculations_v3,exp_v3_000116,2023.00,10.00,4.00,False,False,False,True,40
Ryan,2023-10-23,Wells Fargo Autograph,Amazon,,90.25,,Chargers & Lysine,,,90.25,,0.00,simple,False,,expense_history_csv,Consolidated_Expense_History_20250622.csv,2025-07-18T12:32:53.413399,3.0,advanced_calculations_v3,exp_v3_000117,2023.00,10.00,4.00,False,False,False,True,40
Ryan,2023-10-23,Wells Fargo Autograph,Scottsdale Sports BK,,36.33,36.33,,,,36.33,36.33,0.00,simple,False,,expense_history_csv,Consolidated_Expense_History_20250622.csv,2025-07-18T12:32:53.413399,3.0,advanced_calculations_v3,exp_v3_000118,2023.00,10.00,4.00,False,False,False,True,40
Ryan,2023-10-24,Wells Fargo Autograph,Fry's,,32.02,,Prescriptions,,,32.02,,0.00,simple,False,,expense_history_csv,Consolidated_Expense_History_20250622.csv,2025-07-18T12:32:53.413399,3.0,advanced_calculations_v3,exp_v3_000119,2023.00,10.00,4.00,False,False,False,True,40
Ryan,2023-10-24,Wells Fargo Autograph,Amazon,,6.42,6.42,Fingertip Bandages (charged to my card?),,,6.42,6.42,1.00,simple,False,Mathematical operation: (charged to my card?),expense_history_csv,Consolidated_Expense_History_20250622.csv,2025-07-18T12:32:53.413399,3.0,advanced_calculations_v3,exp_v3_000120,2023.00,10.00,4.00,False,False,False,True,60
Ryan,2023-10-27,Wells Fargo Autograph,Sneaky Bird,,20.05,,,,,20.05,,0.00,simple,False,,expense_history_csv,Consolidated_Expense_History_20250622.csv,2025-07-18T12:32:53.413399,3.0,advanced_calculations_v3,exp_v3_000121,2023.00,10.00,4.00,False,False,False,True,20
Ryan,2023-10-28,Wells Fargo Autograph,Taste of China,,31.71,31.71,,,,31.71,31.71,0.00,simple,False,,expense_history_csv,Consolidated_Expense_History_20250622.csv,2025-07-18T12:32:53.413399,3.0,advanced_calculations_v3,exp_v3_000122,2023.00,10.00,4.00,False,False,False,True,40
Ryan,2023-10-28,Wells Fargo Autograph,Culinary Concepts,,73.70,73.70,,,,73.70,73.70,0.00,simple,False,,expense_history_csv,Consolidated_Expense_History_20250622.csv,2025-07-18T12:32:53.413399,3.0,advanced_calculations_v3,exp_v3_000123,2023.00,10.00,4.00,False,False,False,True,40
Ryan,2023-10-28,Wells Fargo Autograph,Culinary Concepts,,69.08,69.08,,,,69.08,69.08,0.00,simple,False,,expense_history_csv,Consolidated_Expense_History_20250622.csv,2025-07-18T12:32:53.413399,3.0,advanced_calculations_v3,exp_v3_000124,2023.00,10.00,4.00,False,False,False,True,40
Ryan,2023-10-28,Wells Fargo Autograph,Culinary Concepts,,52.44,30.00,,,,52.44,30.00,0.00,simple,False,,expense_history_csv,Consolidated_Expense_History_20250622.csv,2025-07-18T12:32:53.413399,3.0,advanced_calculations_v3,exp_v3_000125,2023.00,10.00,4.00,False,False,False,True,40
Ryan,2023-11-04,Wells Fargo Autograph,Bashas,,37.14,37.14,,,,37.14,37.14,0.00,simple,False,,expense_history_csv,Consolidated_Expense_History_20250622.csv,2025-07-18T12:32:53.413399,3.0,advanced_calculations_v3,exp_v3_000126,2023.00,11.00,4.00,False,False,False,True,40
Ryan,2023-11-05,Wells Fargo Autograph,Sapiens Paleo Kitchen,,55.36,55.36,,,,55.36,55.36,0.00,simple,False,,expense_history_csv,Consolidated_Expense_History_20250622.csv,2025-07-18T12:32:53.413399,3.0,advanced_calculations_v3,exp_v3_000127,2023.00,11.00,4.00,False,False,False,True,40
Ryan,2023-10-23,Wells Fargo,Ethan,,545.00,545.00,545 / 8.9 = $61.23,,,545.00,545.00,1.00,simple,False,Mathematical operation: 545 / 8.9,expense_history_csv,Consolidated_Expense_History_20250622.csv,2025-07-18T12:32:53.413399,3.0,advanced_calculations_v3,exp_v3_000128,2023.00,10.00,4.00,False,False,False,True,60
Ryan,2023-10-27,Wells Fargo,Lyft,,9.14,,"$45,224.63",,,9.14,,0.00,simple,False,,expense_history_csv,Consolidated_Expense_History_20250622.csv,2025-07-18T12:32:53.413399,3.0,advanced_calculations_v3,exp_v3_000129,2023.00,10.00,4.00,False,False,False,True,40
Ryan,2023-10-30,Wells Fargo,Lyft,,8.95,8.95,"$45,227.71",,,8.95,8.95,0.00,simple,False,,expense_history_csv,Consolidated_Expense_History_20250622.csv,2025-07-18T12:32:53.413399,3.0,advanced_calculations_v3,exp_v3_000130,2023.00,10.00,4.00,False,False,False,True,60
Ryan,2023-10-30,Wells Fargo,Lyft,,12.07,,"$45,227.88",,,12.07,,0.00,simple,False,,expense_history_csv,Consolidated_Expense_History_20250622.csv,2025-07-18T12:32:53.413399,3.0,advanced_calculations_v3,exp_v3_000131,2023.00,10.00,4.00,False,False,False,True,40
Ryan,2023-10-31,Wells Fargo,Cantera,,365.40,365.40,Administration and Application Fees,,,365.40,365.40,0.00,simple,False,,expense_history_csv,Consolidated_Expense_History_20250622.csv,2025-07-18T12:32:53.413399,3.0,advanced_calculations_v3,exp_v3_000132,2023.00,10.00,4.00,False,False,False,True,60
Ryan,2023-11-06,Wells Fargo,Bro,,220.00,220.00,,,,220.00,220.00,0.00,simple,False,,expense_history_csv,Consolidated_Expense_History_20250622.csv,2025-07-18T12:32:53.413399,3.0,advanced_calculations_v3,exp_v3_000133,2023.00,11.00,4.00,False,False,False,True,40
Ryan,2023-11-06,Wells Fargo,Francisco,,150.00,150.00,Clean Zen Den,,,150.00,150.00,0.00,simple,False,,expense_history_csv,Consolidated_Expense_History_20250622.csv,2025-07-18T12:32:53.413399,3.0,advanced_calculations_v3,exp_v3_000134,2023.00,11.00,4.00,False,False,False,True,60
Ryan,2023-11-05,Wells Fargo,Rebecca,,220.00,120.00,,,,220.00,120.00,0.00,simple,False,,expense_history_csv,Consolidated_Expense_History_20250622.csv,2025-07-18T12:32:53.413399,3.0,advanced_calculations_v3,exp_v3_000135,2023.00,11.00,4.00,False,False,False,True,40
Ryan,,Wells Fargo,San Palmas,,308.45,308.45,Administration and Application Fees,,,308.45,308.45,0.00,simple,False,,expense_history_csv,Consolidated_Expense_History_20250622.csv,2025-07-18T12:32:53.413399,3.0,advanced_calculations_v3,exp_v3_000136,,,,False,False,False,False,20
Jordyn,2023-10-22,Wells Fargo,Living Room,,79.00,79.00,,,,79.00,79.00,0.00,simple,False,,expense_history_csv,Consolidated_Expense_History_20250622.csv,2025-07-18T12:32:53.413399,3.0,advanced_calculations_v3,exp_v3_000137,2023.00,10.00,4.00,False,False,False,True,40
Jordyn,2023-10-23,Wells Fargo,DoorDash,,51.83,51.83,,,,51.83,51.83,0.00,simple,False,,expense_history_csv,Consolidated_Expense_History_20250622.csv,2025-07-18T12:32:53.413399,3.0,advanced_calculations_v3,exp_v3_000138,2023.00,10.00,4.00,False,False,False,True,40
Jordyn,2023-10-23,Wells Fargo,Fry's,,171.39,171.39,,,,171.39,171.39,0.00,simple,False,,expense_history_csv,Consolidated_Expense_History_20250622.csv,2025-07-18T12:32:53.413399,3.0,advanced_calculations_v3,exp_v3_000139,2023.00,10.00,4.00,False,False,False,True,40
Jordyn,2023-10-24,Wells Fargo,Sprouts,,23.00,23.00,,,,23.00,23.00,0.00,simple,False,,expense_history_csv,Consolidated_Expense_History_20250622.csv,2025-07-18T12:32:53.413399,3.0,advanced_calculations_v3,exp_v3_000140,2023.00,10.00,4.00,False,False,False,True,40
Jordyn,2023-10-24,Wells Fargo,Draft Kings,,27.27,27.27,,,,27.27,27.27,0.00,simple,False,,expense_history_csv,Consolidated_Expense_History_20250622.csv,2025-07-18T12:32:53.413399,3.0,advanced_calculations_v3,exp_v3_000141,2023.00,10.00,4.00,False,False,False,True,40
Jordyn,2023-10-27,Wells Fargo,Walmart,,17.70,17.70,,,,17.70,17.70,0.00,simple,False,,expense_history_csv,Consolidated_Expense_History_20250622.csv,2025-07-18T12:32:53.413399,3.0,advanced_calculations_v3,exp_v3_000142,2023.00,10.00,4.00,False,False,False,True,40
Jordyn,2023-10-28,Wells Fargo,Festival,,30.00,30.00,Cash for?,,,30.00,30.00,0.00,simple,False,,expense_history_csv,Consolidated_Expense_History_20250622.csv,2025-07-18T12:32:53.413399,3.0,advanced_calculations_v3,exp_v3_000143,2023.00,10.00,4.00,False,False,False,True,60
Jordyn,2023-10-28,Wells Fargo,Uber,,15.00,15.00,,,,15.00,15.00,0.00,simple,False,,expense_history_csv,Consolidated_Expense_History_20250622.csv,2025-07-18T12:32:53.413399,3.0,advanced_calculations_v3,exp_v3_000144,2023.00,10.00,4.00,False,False,False,True,40
Jordyn,2023-10-28,Wells Fargo,Culinary Concepts,,32.48,32.48,,,,32.48,32.48,0.00,simple,False,,expense_history_csv,Consolidated_Expense_History_20250622.csv,2025-07-18T12:32:53.413399,3.0,advanced_calculations_v3,exp_v3_000145,2023.00,10.00,4.00,False,False,False,True,40
Jordyn,2023-10-28,Wells Fargo,Culinary Concepts,,16.75,16.75,,,,16.75,16.75,0.00,simple,False,,expense_history_csv,Consolidated_Expense_History_20250622.csv,2025-07-18T12:32:53.413399,3.0,advanced_calculations_v3,exp_v3_000146,2023.00,10.00,4.00,False,False,False,True,40
Jordyn,2023-10-29,Wells Fargo,Fry's,,240.68,240.68,,,,240.68,240.68,0.00,simple,False,,expense_history_csv,Consolidated_Expense_History_20250622.csv,2025-07-18T12:32:53.413399,3.0,advanced_calculations_v3,exp_v3_000147,2023.00,10.00,4.00,False,False,False,True,40
Jordyn,2023-11-01,,Target,,16.21,15.00,,,,16.21,15.00,0.00,simple,False,,expense_history_csv,Consolidated_Expense_History_20250622.csv,2025-07-18T12:32:53.413399,3.0,advanced_calculations_v3,exp_v3_000148,2023.00,11.00,4.00,False,False,False,True,40
Jordyn,2023-11-04,,Bashas,,26.63,26.63,,,,26.63,26.63,0.00,simple,False,,expense_history_csv,Consolidated_Expense_History_20250622.csv,2025-07-18T12:32:53.413399,3.0,advanced_calculations_v3,exp_v3_000149,2023.00,11.00,4.00,False,False,False,True,40
Ryan,2023-11-05,,Sapiens Paleo Kitchen,,55.35,55.35,,,,55.35,55.35,0.00,simple,False,,expense_history_csv,Consolidated_Expense_History_20250622.csv,2025-07-18T12:32:53.413399,3.0,advanced_calculations_v3,exp_v3_000150,2023.00,11.00,4.00,False,False,False,True,40
Ryan,2023-11-08,,Amazon,,44.31,44.31,,,,44.31,44.31,0.00,simple,False,,expense_history_csv,Consolidated_Expense_History_20250622.csv,2025-07-18T12:32:53.413399,3.0,advanced_calculations_v3,exp_v3_000151,2023.00,11.00,4.00,False,False,False,True,40
Ryan,2023-11-10,Mercury,Amazon,,102.62,49.99,Dohm & LectroFan Sound Machines,,,102.62,49.99,0.00,simple,False,,expense_history_csv,Consolidated_Expense_History_20250622.csv,2025-07-18T12:32:53.413399,3.0,advanced_calculations_v3,exp_v3_000152,2023.00,11.00,4.00,False,False,False,True,60
Ryan,2023-11-12,Mercury,Amazon,,97.19,,Sound+Sleep Sound Machine,,,97.19,,0.00,simple,False,,expense_history_csv,Consolidated_Expense_History_20250622.csv,2025-07-18T12:32:53.413399,3.0,advanced_calculations_v3,exp_v3_000153,2023.00,11.00,4.00,False,False,False,True,40
Ryan,2023-11-12,Mercury,Walmart,,51.53,51.53,Hardware for bed + Tool Kit,,,51.53,51.53,0.00,simple,False,,expense_history_csv,Consolidated_Expense_History_20250622.csv,2025-07-18T12:32:53.413399,3.0,advanced_calculations_v3,exp_v3_000154,2023.00,11.00,4.00,False,False,False,True,60
Ryan,2023-11-13,Mercury,Walmart,,139.12,30.00,Totes & Tito (reassess next time),,,139.12,30.00,4.00,complex,True,Mathematical operation: (reassess next time); Manual review required: Reassess,expense_history_csv,Consolidated_Expense_History_20250622.csv,2025-07-18T12:32:53.413399,3.0,advanced_calculations_v3,exp_v3_000155,2023.00,11.00,4.00,True,False,False,True,40
Ryan,2023-11-16,Capital One Quiksilver,Doordash,,17.66,,Chipotle,,,17.66,,0.00,simple,False,,expense_history_csv,Consolidated_Expense_History_20250622.csv,2025-07-18T12:32:53.413399,3.0,advanced_calculations_v3,exp_v3_000156,2023.00,11.00,4.00,False,False,False,True,40
Ryan,2023-11-16,Capital One Savor One,Fry's,,325.58,325.58,,,,325.58,325.58,0.00,simple,False,,expense_history_csv,Consolidated_Expense_History_20250622.csv,2025-07-18T12:32:53.413399,3.0,advanced_calculations_v3,exp_v3_000157,2023.00,11.00,4.00,False,False,False,True,40
Ryan,2023-11-19,Capital One Savor One,Fry's,,88.20,88.20,,,,88.20,88.20,0.00,simple,False,,expense_history_csv,Consolidated_Expense_History_20250622.csv,2025-07-18T12:32:53.413399,3.0,advanced_calculations_v3,exp_v3_000158,2023.00,11.00,4.00,False,False,False,True,40
Ryan,2023-11-19,Wells Fargo Autograph,Walmart,,41.67,,"Didn't use number, not available on purchase history (gas)",,,41.67,,1.00,simple,False,Mathematical operation: (gas),expense_history_csv,Consolidated_Expense_History_20250622.csv,2025-07-18T12:32:53.413399,3.0,advanced_calculations_v3,exp_v3_000159,2023.00,11.00,4.00,False,False,False,True,40
Ryan,2023-11-15,Wells Fargo Autograph,Target,,242.68,,Dyson,,,242.68,,0.00,simple,False,,expense_history_csv,Consolidated_Expense_History_20250622.csv,2025-07-18T12:32:53.413399,3.0,advanced_calculations_v3,exp_v3_000160,2023.00,11.00,4.00,False,False,False,True,40
Ryan,2023-11-15,Wells Fargo Autograph,Target,,76.01,76.01,"Not in history - didn't use number with purchase - need  (rug, wine glasses, etc.)",,,76.01,76.01,1.00,simple,False,"Mathematical operation: (rug, wine glasses, etc.)",expense_history_csv,Consolidated_Expense_History_20250622.csv,2025-07-18T12:32:53.413399,3.0,advanced_calculations_v3,exp_v3_000161,2023.00,11.00,4.00,False,False,False,True,60
Ryan,2023-11-15,Wells Fargo Autograph,Culvers,,19.64,19.64,,,,19.64,19.64,0.00,simple,False,,expense_history_csv,Consolidated_Expense_History_20250622.csv,2025-07-18T12:32:53.413399,3.0,advanced_calculations_v3,exp_v3_000162,2023.00,11.00,4.00,False,False,False,True,40
Ryan,2023-11-16,Wells Fargo Autograph,Amazon,,77.61,77.61,Bathroom Items,,,77.61,77.61,0.00,simple,False,,expense_history_csv,Consolidated_Expense_History_20250622.csv,2025-07-18T12:32:53.413399,3.0,advanced_calculations_v3,exp_v3_000163,2023.00,11.00,4.00,False,False,False,True,60
Ryan,2023-11-16,Wells Fargo Autograph,Amazon,,48.00,48.00,Bathroom Items,,,48.00,48.00,0.00,simple,False,,expense_history_csv,Consolidated_Expense_History_20250622.csv,2025-07-18T12:32:53.413399,3.0,advanced_calculations_v3,exp_v3_000164,2023.00,11.00,4.00,False,False,False,True,60
Ryan,2023-11-17,Wells Fargo Autograph,Amazon,,26.94,26.94,Bathroom Items,,,26.94,26.94,0.00,simple,False,,expense_history_csv,Consolidated_Expense_History_20250622.csv,2025-07-18T12:32:53.413399,3.0,advanced_calculations_v3,exp_v3_000165,2023.00,11.00,4.00,False,False,False,True,60
Ryan,2023-11-10,Wells Fargo,Rebecca,,225.00,225.00,,,,225.00,225.00,0.00,simple,False,,expense_history_csv,Consolidated_Expense_History_20250622.csv,2025-07-18T12:32:53.413399,3.0,advanced_calculations_v3,exp_v3_000166,2023.00,11.00,4.00,False,False,False,True,40
Ryan,2023-11-13,Wells Fargo,SRP,,190.00,190.00,Electric,,,190.00,190.00,0.00,simple,False,,expense_history_csv,Consolidated_Expense_History_20250622.csv,2025-07-18T12:32:53.413399,3.0,advanced_calculations_v3,exp_v3_000167,2023.00,11.00,4.00,False,False,False,True,60
Ryan,2023-11-14,Wells Fargo,Francisco,,150.00,150.00,Zen Den Clean,,,150.00,150.00,0.00,simple,False,,expense_history_csv,Consolidated_Expense_History_20250622.csv,2025-07-18T12:32:53.413399,3.0,advanced_calculations_v3,exp_v3_000168,2023.00,11.00,4.00,False,False,False,True,60
Ryan,2023-11-18,Wells Fargo,Cox,,119.99,119.99,,,,119.99,119.99,0.00,simple,False,,expense_history_csv,Consolidated_Expense_History_20250622.csv,2025-07-18T12:32:53.413399,3.0,advanced_calculations_v3,exp_v3_000169,2023.00,11.00,4.00,False,False,False,True,40
Ryan,2023-11-12,Apple,Bro,,230.00,230.00,,,,230.00,230.00,0.00,simple,False,,expense_history_csv,Consolidated_Expense_History_20250622.csv,2025-07-18T12:32:53.413399,3.0,advanced_calculations_v3,exp_v3_000170,2023.00,11.00,4.00,False,False,False,True,40
Ryan,2023-11-18,Apple,Bro,,230.00,230.00,,,,230.00,230.00,0.00,simple,False,,expense_history_csv,Consolidated_Expense_History_20250622.csv,2025-07-18T12:32:53.413399,3.0,advanced_calculations_v3,exp_v3_000171,2023.00,11.00,4.00,False,False,False,True,40
Ryan,2023-11-11,Credit One Platinum X5,Frys,,62.00,62.00,,,,62.00,62.00,0.00,simple,False,,expense_history_csv,Consolidated_Expense_History_20250622.csv,2025-07-18T12:32:53.413399,3.0,advanced_calculations_v3,exp_v3_000172,2023.00,11.00,4.00,False,False,False,True,40
Ryan,2023-11-19,Credit One Platinum X6,Target,,179.27,179.27,"House supplies, cleaning, brooms, etc. (includes Target returns",,,179.27,179.27,0.00,simple,False,,expense_history_csv,Consolidated_Expense_History_20250622.csv,2025-07-18T12:32:53.413399,3.0,advanced_calculations_v3,exp_v3_000173,2023.00,11.00,4.00,False,False,False,True,60
Ryan,2023-11-18,Red Card,Target,,286.30,288.00,,,,286.30,288.00,0.00,simple,False,,expense_history_csv,Consolidated_Expense_History_20250622.csv,2025-07-18T12:32:53.413399,3.0,advanced_calculations_v3,exp_v3_000174,2023.00,11.00,4.00,False,False,False,True,40
Ryan,2023-11-19,,GoShare,,76.50,76.50,Couch moving service,,,76.50,76.50,0.00,simple,False,,expense_history_csv,Consolidated_Expense_History_20250622.csv,2025-07-18T12:32:53.413399,3.0,advanced_calculations_v3,exp_v3_000175,2023.00,11.00,4.00,False,False,False,True,60
Jordyn,2023-11-06,Wells Fargo,Frys,,368.83,368.83,late charge,,,368.83,368.83,0.00,simple,False,,expense_history_csv,Consolidated_Expense_History_20250622.csv,2025-07-18T12:32:53.413399,3.0,advanced_calculations_v3,exp_v3_000176,2023.00,11.00,4.00,False,False,False,True,60
Jordyn,2023-11-09,Wells Fargo,Walmart,,30.54,30.54,"items for mom and Jack coming over before pool party (champagne, dip, cheese, etc)",,,30.54,30.54,1.00,simple,False,"Mathematical operation: (champagne, dip, cheese, etc)",expense_history_csv,Consolidated_Expense_History_20250622.csv,2025-07-18T12:32:53.413399,3.0,advanced_calculations_v3,exp_v3_000177,2023.00,11.00,4.00,False,False,False,True,60
Jordyn,2023-11-09,Wells Fargo,Amazon,,44.31,44.31,,,,44.31,44.31,0.00,simple,False,,expense_history_csv,Consolidated_Expense_History_20250622.csv,2025-07-18T12:32:53.413399,3.0,advanced_calculations_v3,exp_v3_000178,2023.00,11.00,4.00,False,False,False,True,40
Jordyn,2023-11-09,Wells Fargo,Amazon,,49.50,49.50,,,,49.50,49.50,0.00,simple,False,,expense_history_csv,Consolidated_Expense_History_20250622.csv,2025-07-18T12:32:53.413399,3.0,advanced_calculations_v3,exp_v3_000179,2023.00,11.00,4.00,False,False,False,True,40
Jordyn,2023-11-11,Wells Fargo,Lings,,64.19,64.19,,,,64.19,64.19,0.00,simple,False,,expense_history_csv,Consolidated_Expense_History_20250622.csv,2025-07-18T12:32:53.413399,3.0,advanced_calculations_v3,exp_v3_000180,2023.00,11.00,4.00,False,False,False,True,40
Jordyn,2023-11-12,Wells Fargo,Amazon,,6.74,6.74,,,,6.74,6.74,0.00,simple,False,,expense_history_csv,Consolidated_Expense_History_20250622.csv,2025-07-18T12:32:53.413399,3.0,advanced_calculations_v3,exp_v3_000181,2023.00,11.00,4.00,False,False,False,True,40
Jordyn,2023-11-12,Wells Fargo,In n Out,,23.18,23.18,,,,23.18,23.18,0.00,simple,False,,expense_history_csv,Consolidated_Expense_History_20250622.csv,2025-07-18T12:32:53.413399,3.0,advanced_calculations_v3,exp_v3_000182,2023.00,11.00,4.00,False,False,False,True,40
Jordyn,2023-11-13,Wells Fargo,Sneaky Bird,,27.31,27.31,,,,27.31,27.31,0.00,simple,False,,expense_history_csv,Consolidated_Expense_History_20250622.csv,2025-07-18T12:32:53.413399,3.0,advanced_calculations_v3,exp_v3_000183,2023.00,11.00,4.00,False,False,False,True,40
Jordyn,2023-11-13,Wells Fargo,Sprouts,,55.00,55.00,,,,55.00,55.00,0.00,simple,False,,expense_history_csv,Consolidated_Expense_History_20250622.csv,2025-07-18T12:32:53.413399,3.0,advanced_calculations_v3,exp_v3_000184,2023.00,11.00,4.00,False,False,False,True,40
Jordyn,2023-11-14,Wells Fargo,Bed bath and beyond,,56.91,56.91,Toaster,,,56.91,56.91,0.00,simple,False,,expense_history_csv,Consolidated_Expense_History_20250622.csv,2025-07-18T12:32:53.413399,3.0,advanced_calculations_v3,exp_v3_000185,2023.00,11.00,4.00,False,False,False,True,60
Jordyn,2023-11-14,Wells Fargo,Amazon,,34.39,34.39,,,,34.39,34.39,0.00,simple,False,,expense_history_csv,Consolidated_Expense_History_20250622.csv,2025-07-18T12:32:53.413399,3.0,advanced_calculations_v3,exp_v3_000186,2023.00,11.00,4.00,False,False,False,True,40
Jordyn,2023-11-14,Wells Fargo,Amazon,,30.71,30.71,,,,30.71,30.71,0.00,simple,False,,expense_history_csv,Consolidated_Expense_History_20250622.csv,2025-07-18T12:32:53.413399,3.0,advanced_calculations_v3,exp_v3_000187,2023.00,11.00,4.00,False,False,False,True,40
Jordyn,2023-11-14,Wells Fargo,Amazon,,26.35,26.35,,,,26.35,26.35,0.00,simple,False,,expense_history_csv,Consolidated_Expense_History_20250622.csv,2025-07-18T12:32:53.413399,3.0,advanced_calculations_v3,exp_v3_000188,2023.00,11.00,4.00,False,False,False,True,40
Jordyn,2023-11-14,Wells Fargo,Amazon,,45.24,45.24,,,,45.24,45.24,0.00,simple,False,,expense_history_csv,Consolidated_Expense_History_20250622.csv,2025-07-18T12:32:53.413399,3.0,advanced_calculations_v3,exp_v3_000189,2023.00,11.00,4.00,False,False,False,True,40
Jordyn,2023-11-15,Wells Fargo,Amazon,,39.79,39.79,,,,39.79,39.79,0.00,simple,False,,expense_history_csv,Consolidated_Expense_History_20250622.csv,2025-07-18T12:32:53.413399,3.0,advanced_calculations_v3,exp_v3_000190,2023.00,11.00,4.00,False,False,False,True,40
Jordyn,2023-11-16,Wells Fargo,Amazon,,16.81,16.81,,,,16.81,16.81,0.00,simple,False,,expense_history_csv,Consolidated_Expense_History_20250622.csv,2025-07-18T12:32:53.413399,3.0,advanced_calculations_v3,exp_v3_000191,2023.00,11.00,4.00,False,False,False,True,40
Jordyn,2023-11-19,Wells Fargo,Amazon,,381.54,46.00,"Ryan only purchases: $70 pillow,  office mat $189.99 ($260) Jordyn only $75",,,381.54,46.00,1.00,simple,False,Mathematical operation: ($260),expense_history_csv,Consolidated_Expense_History_20250622.csv,2025-07-18T12:32:53.413399,3.0,advanced_calculations_v3,exp_v3_000192,2023.00,11.00,4.00,False,False,False,True,60
Ryan,,,Amazon Gift Card,,50.00,,Reassess next time,,,50.00,,3.00,complex,True,Manual review required: Reassess,expense_history_csv,Consolidated_Expense_History_20250622.csv,2025-07-18T12:32:53.413399,3.0,advanced_calculations_v3,exp_v3_000193,,,,True,False,False,False,-20
Ryan,2023-11-20,Mercury,Amazon,,54.01,,Refund (Sleep Machine),,,54.01,,1.00,simple,False,Mathematical operation: (Sleep Machine),expense_history_csv,Consolidated_Expense_History_20250622.csv,2025-07-18T12:32:53.413399,3.0,advanced_calculations_v3,exp_v3_000194,2023.00,11.00,4.00,False,False,False,True,40
Ryan,2023-11-25,Mercury,Whole Foods,,46.35,46.35,Itemization Unavailable,,,46.35,46.35,0.00,simple,False,,expense_history_csv,Consolidated_Expense_History_20250622.csv,2025-07-18T12:32:53.413399,3.0,advanced_calculations_v3,exp_v3_000195,2023.00,11.00,4.00,False,False,False,True,60
Ryan,2023-11-25,Mercury,Robert's Ace Hardware,,93.89,,Reassess next time (some items will be returned /refunded),,,93.89,,4.00,complex,True,Mathematical operation: (some items will be returned /refunded); Manual review required: Reassess,expense_history_csv,Consolidated_Expense_History_20250622.csv,2025-07-18T12:32:53.413399,3.0,advanced_calculations_v3,exp_v3_000196,2023.00,11.00,4.00,True,False,False,True,20
Ryan,2023-11-26,Mercury,Amazon,,10.84,,Clipboard,,,10.84,,0.00,simple,False,,expense_history_csv,Consolidated_Expense_History_20250622.csv,2025-07-18T12:32:53.413399,3.0,advanced_calculations_v3,exp_v3_000197,2023.00,11.00,4.00,False,False,False,True,40
Ryan,2023-11-27,Mercury,Fry's,,37.97,,"Rotisserie Chicken, Oikos, Lettuce",,,37.97,,0.00,simple,False,,expense_history_csv,Consolidated_Expense_History_20250622.csv,2025-07-18T12:32:53.413399,3.0,advanced_calculations_v3,exp_v3_000198,2023.00,11.00,4.00,False,False,False,True,40
Ryan,2023-11-30,Mercury,Amazon,,18.35,7.50,Placemats,,,18.35,7.50,0.00,simple,False,,expense_history_csv,Consolidated_Expense_History_20250622.csv,2025-07-18T12:32:53.413399,3.0,advanced_calculations_v3,exp_v3_000199,2023.00,11.00,4.00,False,False,False,True,60
Ryan,2023-12-01,Mercury,Kohl's,,24.89,24.89,Living Room Table,,,24.89,24.89,0.00,simple,False,,expense_history_csv,Consolidated_Expense_History_20250622.csv,2025-07-18T12:32:53.413399,3.0,advanced_calculations_v3,exp_v3_000200,2023.00,12.00,4.00,False,False,False,True,60
Ryan,2023-12-02,Mercury,Whole Foods,,28.72,28.70,Itemization Unavailable,,,28.72,28.70,0.00,simple,False,,expense_history_csv,Consolidated_Expense_History_20250622.csv,2025-07-18T12:32:53.413399,3.0,advanced_calculations_v3,exp_v3_000201,2023.00,12.00,4.00,False,False,False,True,60
Ryan,2023-12-02,Mercury,Whole Foods,,26.93,26.93,Itemization Unavailable,,,26.93,26.93,0.00,simple,False,,expense_history_csv,Consolidated_Expense_History_20250622.csv,2025-07-18T12:32:53.413399,3.0,advanced_calculations_v3,exp_v3_000202,2023.00,12.00,4.00,False,False,False,True,60
Ryan,2023-12-17,Mercury,Ace Hardware,,36.57,36.57,Dresser Mounting Hardware,,,36.57,36.57,0.00,simple,False,,expense_history_csv,Consolidated_Expense_History_20250622.csv,2025-07-18T12:32:53.413399,3.0,advanced_calculations_v3,exp_v3_000203,2023.00,12.00,4.00,False,False,False,True,60
Ryan,2023-11-22,Capital One Savor One,Fry's,,75.60,75.60,11/20/2023 Order,,,75.60,75.60,1.00,simple,False,Mathematical operation: 11/20,expense_history_csv,Consolidated_Expense_History_20250622.csv,2025-07-18T12:32:53.413399,3.0,advanced_calculations_v3,exp_v3_000204,2023.00,11.00,4.00,False,False,False,True,60
Ryan,2023-11-29,Capital One Savor One,Uber,,20.00,,Return TV,,,20.00,,0.00,simple,False,,expense_history_csv,Consolidated_Expense_History_20250622.csv,2025-07-18T12:32:53.413399,3.0,advanced_calculations_v3,exp_v3_000205,2023.00,11.00,4.00,False,False,False,True,40
Ryan,2023-12-04,Capital One Savor One,Hash Kitchen,,24.55,24.55,Dining Out,,,24.55,24.55,0.00,simple,False,,expense_history_csv,Consolidated_Expense_History_20250622.csv,2025-07-18T12:32:53.413399,3.0,advanced_calculations_v3,exp_v3_000206,2023.00,12.00,4.00,False,False,False,True,60
Ryan,2023-12-05,Capital One Savor One,Fry's,,59.34,25.00,"Laundry Stain Remover, Flowers, Hydrogen Peroxide, Wine",,,59.34,25.00,4.00,exclusion_adjustment,False,Exclusion adjustment: Remover; Exclusion adjustment: Remover,expense_history_csv,Consolidated_Expense_History_20250622.csv,2025-07-18T12:32:53.413399,3.0,advanced_calculations_v3,exp_v3_000207,2023.00,12.00,4.00,True,True,False,True,60
Ryan,2023-12-10,Capital One Savor One,The Whining Pig,,19.92,19.92,Dining Out,,,19.92,19.92,0.00,simple,False,,expense_history_csv,Consolidated_Expense_History_20250622.csv,2025-07-18T12:32:53.413399,3.0,advanced_calculations_v3,exp_v3_000208,2023.00,12.00,4.00,False,False,False,True,60
Ryan,2023-12-11,Capital One Savor One,Fry's,,270.58,231.80,12/11/2023 - $231.80,,,270.58,231.80,1.00,simple,False,Mathematical operation: 12/11,expense_history_csv,Consolidated_Expense_History_20250622.csv,2025-07-18T12:32:53.413399,3.0,advanced_calculations_v3,exp_v3_000209,2023.00,12.00,4.00,False,False,False,True,60
Ryan,2023-12-08,Wells Fargo,Cox,,89.99,89.99,"Nov 14, 2023 ($119.99 - $20 ACP Discount)",,,89.99,89.99,1.00,simple,False,Mathematical operation: ($119.99 - $20 ACP Discount),expense_history_csv,Consolidated_Expense_History_20250622.csv,2025-07-18T12:32:53.413399,3.0,advanced_calculations_v3,exp_v3_000210,2023.00,12.00,4.00,False,False,False,True,60
Ryan,2023-11-15,Wells Fargo Autograph,Target,,242.68,242.68,"In Store Purchase: Storage Trays, Aquafina, Keurig Water Filter, Measuring Cup, Vanity Tray Crackle Cream, Paper Towel Holder, Suction Sink Caddy, Shower Hooks, Shower Heads, Hamper, Wine Glasses, Rug - Where is this rug?! Order was originally $286, final price charged to credit reflects. See below transaction.",,,242.68,242.68,5.00,split_transaction,True,Split transaction: originally $286; Manual review required: Where is this,expense_history_csv,Consolidated_Expense_History_20250622.csv,2025-07-18T12:32:53.413399,3.0,advanced_calculations_v3,exp_v3_000211,2023.00,11.00,4.00,True,False,True,True,40
Ryan,2023-11-15,Wells Fargo Autograph,Target,,76.01,76.01,Glasses & Wine Glasses,,,76.01,76.01,0.00,simple,False,,expense_history_csv,Consolidated_Expense_History_20250622.csv,2025-07-18T12:32:53.413399,3.0,advanced_calculations_v3,exp_v3_000212,2023.00,11.00,4.00,False,False,False,True,60
Ryan,2023-11-15,Wells Fargo Autograph,Culvers,,19.64,19.64,Dining Out,,,19.64,19.64,0.00,simple,False,,expense_history_csv,Consolidated_Expense_History_20250622.csv,2025-07-18T12:32:53.413399,3.0,advanced_calculations_v3,exp_v3_000213,2023.00,11.00,4.00,False,False,False,True,60
Ryan,2023-11-17,Wells Fargo Autograph,Amazon,,48.00,48.00,Shower Items,,,48.00,48.00,0.00,simple,False,,expense_history_csv,Consolidated_Expense_History_20250622.csv,2025-07-18T12:32:53.413399,3.0,advanced_calculations_v3,exp_v3_000214,2023.00,11.00,4.00,False,False,False,True,60
Ryan,2023-11-17,Wells Fargo Autograph,Amazon,,77.61,6.00,"Holder Dispenser, Neck Pillow",,,77.61,6.00,0.00,simple,False,,expense_history_csv,Consolidated_Expense_History_20250622.csv,2025-07-18T12:32:53.413399,3.0,advanced_calculations_v3,exp_v3_000215,2023.00,11.00,4.00,False,False,False,True,60
Ryan,2023-11-17,Wells Fargo Autograph,Amazon,,26.94,26.94,Shower Bathroom Rug,,,26.94,26.94,0.00,simple,False,,expense_history_csv,Consolidated_Expense_History_20250622.csv,2025-07-18T12:32:53.413399,3.0,advanced_calculations_v3,exp_v3_000216,2023.00,11.00,4.00,False,False,False,True,60
Ryan,2023-11-18,Wells Fargo Autograph,Vine Tavern,,17.50,17.50,,,,17.50,17.50,0.00,simple,False,,expense_history_csv,Consolidated_Expense_History_20250622.csv,2025-07-18T12:32:53.413399,3.0,advanced_calculations_v3,exp_v3_000217,2023.00,11.00,4.00,False,False,False,True,40
Ryan,2023-11-18,Wells Fargo Autograph,Robert's Ace Hardware,,31.07,31.07,Hardware,,,31.07,31.07,0.00,simple,False,,expense_history_csv,Consolidated_Expense_History_20250622.csv,2025-07-18T12:32:53.413399,3.0,advanced_calculations_v3,exp_v3_000218,2023.00,11.00,4.00,False,False,False,True,60
Ryan,2023-11-18,Wells Fargo Autograph,Fry's Fuel,,43.12,,When did I get fuel at Fry's?,,,43.12,,0.00,simple,False,,expense_history_csv,Consolidated_Expense_History_20250622.csv,2025-07-18T12:32:53.413399,3.0,advanced_calculations_v3,exp_v3_000219,2023.00,11.00,4.00,False,False,False,True,40
Ryan,2023-11-20,Wells Fargo Autograph,Amazon,,47.89,,"Shower Curtain HOoks, Dohm White Noise Machine",,,47.89,,0.00,simple,False,,expense_history_csv,Consolidated_Expense_History_20250622.csv,2025-07-18T12:32:53.413399,3.0,advanced_calculations_v3,exp_v3_000220,2023.00,11.00,4.00,False,False,False,True,40
Ryan,2023-11-20,Wells Fargo Autograph,GoShare Delivery,,76.50,76.50,Couch delivery service,,,76.50,76.50,0.00,simple,False,,expense_history_csv,Consolidated_Expense_History_20250622.csv,2025-07-18T12:32:53.413399,3.0,advanced_calculations_v3,exp_v3_000221,2023.00,11.00,4.00,False,False,False,True,60
Ryan,2023-11-20,Wells Fargo Autograph,Amazon,,51.19,,Jordyn's Pillow,,,51.19,,0.00,simple,False,,expense_history_csv,Consolidated_Expense_History_20250622.csv,2025-07-18T12:32:53.413399,3.0,advanced_calculations_v3,exp_v3_000222,2023.00,11.00,4.00,False,False,False,True,40
Ryan,2023-11-25,Wells Fargo Autograph,Cooper's Hawk,,44.99,44.99,Dining Out,,,44.99,44.99,0.00,simple,False,,expense_history_csv,Consolidated_Expense_History_20250622.csv,2025-07-18T12:32:53.413399,3.0,advanced_calculations_v3,exp_v3_000223,2023.00,11.00,4.00,False,False,False,True,60
Ryan,2023-12-02,Wells Fargo Autograph,Yama Sushi,,35.13,35.13,Dining Out,,,35.13,35.13,0.00,simple,False,,expense_history_csv,Consolidated_Expense_History_20250622.csv,2025-07-18T12:32:53.413399,3.0,advanced_calculations_v3,exp_v3_000224,2023.00,12.00,4.00,False,False,False,True,60
Ryan,2023-12-09,Wells Fargo Autograph,Carrabba's Italian Grill,,75.44,,Shitttttyyyyyyyyyy assssssss fooooooooooood.,,,75.44,,0.00,simple,False,,expense_history_csv,Consolidated_Expense_History_20250622.csv,2025-07-18T12:32:53.413399,3.0,advanced_calculations_v3,exp_v3_000225,2023.00,12.00,4.00,False,False,False,True,40
Ryan,2023-11-20,Credit One Platinum Black,Amazon,,22.15,,Nasal Spray,,,22.15,,0.00,simple,False,,expense_history_csv,Consolidated_Expense_History_20250622.csv,2025-07-18T12:32:53.413399,3.0,advanced_calculations_v3,exp_v3_000226,2023.00,11.00,4.00,False,False,False,True,40
Ryan,2023-11-29,Credit One Platinum Black,Amazon,,24.78,,Drug Panels,,,24.78,,0.00,simple,False,,expense_history_csv,Consolidated_Expense_History_20250622.csv,2025-07-18T12:32:53.413399,3.0,advanced_calculations_v3,exp_v3_000227,2023.00,11.00,4.00,False,False,False,True,40
Ryan,2023-11-19,Credit One Platinum Red x5,Valley Ace Hardware,,2.00,,Duh,,,2.00,,0.00,simple,False,,expense_history_csv,Consolidated_Expense_History_20250622.csv,2025-07-18T12:32:53.413399,3.0,advanced_calculations_v3,exp_v3_000228,2023.00,11.00,4.00,False,False,False,True,40
Ryan,2023-11-21,Credit One Platinum Red x5,Fry's,,92.96,,Unknown,,,92.96,,0.00,simple,False,,expense_history_csv,Consolidated_Expense_History_20250622.csv,2025-07-18T12:32:53.413399,3.0,advanced_calculations_v3,exp_v3_000229,2023.00,11.00,4.00,False,False,False,True,40
Ryan,2023-11-21,Credit One Platinum Red x5,Walmart,,29.82,,Mom Medicine,,,29.82,,0.00,simple,False,,expense_history_csv,Consolidated_Expense_History_20250622.csv,2025-07-18T12:32:53.413399,3.0,advanced_calculations_v3,exp_v3_000230,2023.00,11.00,4.00,False,False,False,True,40
Ryan,2023-11-26,Credit One Platinum Red x5,Fry's,,99.92,99.92,11/26/2023 - $197.54,,,99.92,99.92,1.00,simple,False,Mathematical operation: 11/26,expense_history_csv,Consolidated_Expense_History_20250622.csv,2025-07-18T12:32:53.413399,3.0,advanced_calculations_v3,exp_v3_000231,2023.00,11.00,4.00,False,False,False,True,60
Ryan,2023-11-27,Credit One Platinum Red x5,Walmart,,21.79,8.93,"Raid refunded, hotels $8.93",,,21.79,8.93,0.00,simple,False,,expense_history_csv,Consolidated_Expense_History_20250622.csv,2025-07-18T12:32:53.413399,3.0,advanced_calculations_v3,exp_v3_000232,2023.00,11.00,4.00,False,False,False,True,60
Ryan,2023-11-27,Credit One Platinum Red x5,Fry's,,33.12,,"Oikos, Chicken, Lettuce",,,33.12,,0.00,simple,False,,expense_history_csv,Consolidated_Expense_History_20250622.csv,2025-07-18T12:32:53.413399,3.0,advanced_calculations_v3,exp_v3_000233,2023.00,11.00,4.00,False,False,False,True,40
Ryan,2023-12-04,Credit One Platinum Red x5,Fry's,,35.41,35.41,"Granola, Luna Bars, Wine",,,35.41,35.41,0.00,simple,False,,expense_history_csv,Consolidated_Expense_History_20250622.csv,2025-07-18T12:32:53.413399,3.0,advanced_calculations_v3,exp_v3_000234,2023.00,12.00,4.00,False,False,False,True,60
Ryan,2023-12-05,Credit One Platinum Red x5,Fry's,,399.47,399.47,12/05/2023 - $399.47,,,399.47,399.47,1.00,simple,False,Mathematical operation: 12/05,expense_history_csv,Consolidated_Expense_History_20250622.csv,2025-07-18T12:32:53.413399,3.0,advanced_calculations_v3,exp_v3_000235,2023.00,12.00,4.00,False,False,False,True,60
Ryan,2023-12-06,Credit One Platinum Red x5,Fry's,,20.26,20.26,In Store - Aquafina,,,20.26,20.26,0.00,simple,False,,expense_history_csv,Consolidated_Expense_History_20250622.csv,2025-07-18T12:32:53.413399,3.0,advanced_calculations_v3,exp_v3_000236,2023.00,12.00,4.00,False,False,False,True,60
Ryan,2023-12-08,Credit One Platinum Red x5,Fry's,,44.55,16.99,"In Store - Oikos, Sushi, Wijne",,,44.55,16.99,0.00,simple,False,,expense_history_csv,Consolidated_Expense_History_20250622.csv,2025-07-18T12:32:53.413399,3.0,advanced_calculations_v3,exp_v3_000237,2023.00,12.00,4.00,False,False,False,True,60
Ryan,2023-12-11,Credit One Platinum Red x5,Fry's,,16.99,16.99,In store - Wine,,,16.99,16.99,0.00,simple,False,,expense_history_csv,Consolidated_Expense_History_20250622.csv,2025-07-18T12:32:53.413399,3.0,advanced_calculations_v3,exp_v3_000238,2023.00,12.00,4.00,False,False,False,True,60
Ryan,2023-12-11,Credit One Platinum Red x5,Fry's,,78.39,78.31,"12/11/2023 - $78.31 (Tuna, Cheerios, Tomatoes, Beef Jerky, Small Trash Bags, Lime, Taco Seasoning Mix, Green Bell Pepper, Seltzer",,,78.39,78.31,1.00,simple,False,Mathematical operation: 12/11,expense_history_csv,Consolidated_Expense_History_20250622.csv,2025-07-18T12:32:53.413399,3.0,advanced_calculations_v3,exp_v3_000239,2023.00,12.00,4.00,False,False,False,True,60
Ryan,2023-11-23,Apple Wallet,Bro,,230.00,230.00,-,,,230.00,230.00,0.00,simple,False,,expense_history_csv,Consolidated_Expense_History_20250622.csv,2025-07-18T12:32:53.413399,3.0,advanced_calculations_v3,exp_v3_000240,2023.00,11.00,4.00,False,False,False,True,60
Ryan,2023-12-05,Apple Wallet,Bro,,80.00,80.00,-,,,80.00,80.00,0.00,simple,False,,expense_history_csv,Consolidated_Expense_History_20250622.csv,2025-07-18T12:32:53.413399,3.0,advanced_calculations_v3,exp_v3_000241,2023.00,12.00,4.00,False,False,False,True,60
Ryan,2023-12-10,Apple Wallet,Bro,,230.00,230.00,-,,,230.00,230.00,0.00,simple,False,,expense_history_csv,Consolidated_Expense_History_20250622.csv,2025-07-18T12:32:53.413399,3.0,advanced_calculations_v3,exp_v3_000242,2023.00,12.00,4.00,False,False,False,True,60
Ryan,2023-11-17,Wells Fargo,Rebecca,,220.00,220.00,-,,,220.00,220.00,0.00,simple,False,,expense_history_csv,Consolidated_Expense_History_20250622.csv,2025-07-18T12:32:53.413399,3.0,advanced_calculations_v3,exp_v3_000243,2023.00,11.00,4.00,False,False,False,True,60
Ryan,2023-11-04,Cash,Rebecca,,225.00,225.00,"(Missed, ATM Withdrawal Due to Rebecca Not Wanting Paper Trail. Caught this time itemizing with text messages)",,,225.00,225.00,1.00,simple,False,"Mathematical operation: (Missed, ATM Withdrawal Due to Rebecca Not Wanting Paper Trail. Caught this time itemizing with text messages)",expense_history_csv,Consolidated_Expense_History_20250622.csv,2025-07-18T12:32:53.413399,3.0,advanced_calculations_v3,exp_v3_000244,2023.00,11.00,4.00,False,False,False,True,60
Ryan,2023-12-02,Apple Pay,Rebecca,,60.00,60.00,-,,,60.00,60.00,0.00,simple,False,,expense_history_csv,Consolidated_Expense_History_20250622.csv,2025-07-18T12:32:53.413399,3.0,advanced_calculations_v3,exp_v3_000245,2023.00,12.00,4.00,False,False,False,True,60
Ryan,2023-12-04,Cash,Rebecca,,220.00,220.00,-,,,220.00,220.00,0.00,simple,False,,expense_history_csv,Consolidated_Expense_History_20250622.csv,2025-07-18T12:32:53.413399,3.0,advanced_calculations_v3,exp_v3_000246,2023.00,12.00,4.00,False,False,False,True,60
Ryan,2023-12-08,Cash,Rebecca,,220.00,220.00,$210 Cash / $10 Apple Pay,,,220.00,220.00,0.00,simple,False,,expense_history_csv,Consolidated_Expense_History_20250622.csv,2025-07-18T12:32:53.413399,3.0,advanced_calculations_v3,exp_v3_000247,2023.00,12.00,4.00,False,False,False,True,60
Ryan,2023-11-20,EBT,Fry's,,36.34,36.34,"Cholula, Granola, Luna Bars",,,36.34,36.34,0.00,simple,False,,expense_history_csv,Consolidated_Expense_History_20250622.csv,2025-07-18T12:32:53.413399,3.0,advanced_calculations_v3,exp_v3_000248,2023.00,11.00,4.00,False,False,False,True,60
Ryan,2023-11-22,EBT,Fry's,,157.04,157.04,11/20/2023 - $232.64 (Processed Late - Capital One Itemized Prior Cycle),,,157.04,157.04,2.00,simple,False,Mathematical operation: 11/20; Mathematical operation: (Processed Late - Capital One Itemized Prior Cycle),expense_history_csv,Consolidated_Expense_History_20250622.csv,2025-07-18T12:32:53.413399,3.0,advanced_calculations_v3,exp_v3_000249,2023.00,11.00,4.00,False,False,False,True,60
Ryan,2023-11-26,EBT,Fry's,,97.62,97.62,11/26/2023 - $197.54,,,97.62,97.62,1.00,simple,False,Mathematical operation: 11/26,expense_history_csv,Consolidated_Expense_History_20250622.csv,2025-07-18T12:32:53.413399,3.0,advanced_calculations_v3,exp_v3_000250,2023.00,11.00,4.00,False,False,False,True,60
Jordyn,2023-11-22,,Sprouts,,37.50,37.50,Itemization Unavailable,,,37.50,37.50,0.00,simple,False,,expense_history_csv,Consolidated_Expense_History_20250622.csv,2025-07-18T12:32:53.413399,3.0,advanced_calculations_v3,exp_v3_000251,2023.00,11.00,4.00,False,False,False,True,60
Jordyn,2023-11-23,,Amazon,,381.54,306.60,"Pizza tray, office chair mat, strainer, towel hooks, pillow. Refunded shirts, $25.99, $28.99, $19.99 = 74.94",,,381.54,306.60,1.00,simple,False,Mathematical operation: = 74.94,expense_history_csv,Consolidated_Expense_History_20250622.csv,2025-07-18T12:32:53.413399,3.0,advanced_calculations_v3,exp_v3_000252,2023.00,11.00,4.00,False,False,False,True,60
Jordyn,2023-11-27,,Pokitrition,,29.18,29.18,Dining Out,,,29.18,29.18,0.00,simple,False,,expense_history_csv,Consolidated_Expense_History_20250622.csv,2025-07-18T12:32:53.413399,3.0,advanced_calculations_v3,exp_v3_000253,2023.00,11.00,4.00,False,False,False,True,60
Jordyn,2023-11-29,,Amazon,,43.57,,Back Massager,,,43.57,,0.00,simple,False,,expense_history_csv,Consolidated_Expense_History_20250622.csv,2025-07-18T12:32:53.413399,3.0,advanced_calculations_v3,exp_v3_000254,2023.00,11.00,4.00,False,False,False,True,40
Jordyn,2023-11-30,,Fry's,,26.11,52.22,Food,,,26.11,52.22,0.00,simple,False,,expense_history_csv,Consolidated_Expense_History_20250622.csv,2025-07-18T12:32:53.413399,3.0,advanced_calculations_v3,exp_v3_000255,2023.00,11.00,4.00,False,False,False,True,60
Jordyn,2023-12-01,,Whole Foods,,46.73,46.73,Itemization Unavailable,,,46.73,46.73,0.00,simple,False,,expense_history_csv,Consolidated_Expense_History_20250622.csv,2025-07-18T12:32:53.413399,3.0,advanced_calculations_v3,exp_v3_000256,2023.00,12.00,4.00,False,False,False,True,60
Jordyn,2023-12-01,,Amazon,,25.87,25.87,Steel decorative balls,,,25.87,25.87,0.00,simple,False,,expense_history_csv,Consolidated_Expense_History_20250622.csv,2025-07-18T12:32:53.413399,3.0,advanced_calculations_v3,exp_v3_000257,2023.00,12.00,4.00,False,False,False,True,60
Jordyn,2023-12-02,,Yama Sushi,,49.13,49.13,Dining Out,,,49.13,49.13,0.00,simple,False,,expense_history_csv,Consolidated_Expense_History_20250622.csv,2025-07-18T12:32:53.413399,3.0,advanced_calculations_v3,exp_v3_000258,2023.00,12.00,4.00,False,False,False,True,60
Jordyn,2023-12-03,,Sprouts,,31.34,31.34,Itemization Unavailable,,,31.34,31.34,0.00,simple,False,,expense_history_csv,Consolidated_Expense_History_20250622.csv,2025-07-18T12:32:53.413399,3.0,advanced_calculations_v3,exp_v3_000259,2023.00,12.00,4.00,False,False,False,True,60
Jordyn,2023-12-03,,Amazon,,21.07,21.07,Stainless Steel Rotation Fruit Bowl,,,21.07,21.07,0.00,simple,False,,expense_history_csv,Consolidated_Expense_History_20250622.csv,2025-07-18T12:32:53.413399,3.0,advanced_calculations_v3,exp_v3_000260,2023.00,12.00,4.00,False,False,False,True,60
Jordyn,2023-12-04,,Sprouts,,45.09,45.09,Itemization Unavailable,,,45.09,45.09,0.00,simple,False,,expense_history_csv,Consolidated_Expense_History_20250622.csv,2025-07-18T12:32:53.413399,3.0,advanced_calculations_v3,exp_v3_000261,2023.00,12.00,4.00,False,False,False,True,60
Jordyn,2023-12-06,,Amazon,,48.50,48.50,Glutenease,,,48.50,48.50,0.00,simple,False,,expense_history_csv,Consolidated_Expense_History_20250622.csv,2025-07-18T12:32:53.413399,3.0,advanced_calculations_v3,exp_v3_000262,2023.00,12.00,4.00,False,False,False,True,60
Jordyn,2023-12-09,,Fry's,,24.90,24.99,"Ketchup, Potatoes, BBQ Sauces, Carrots (Hanukkah Dinner)",,,24.90,24.99,1.00,simple,False,Mathematical operation: (Hanukkah Dinner),expense_history_csv,Consolidated_Expense_History_20250622.csv,2025-07-18T12:32:53.413399,3.0,advanced_calculations_v3,exp_v3_000263,2023.00,12.00,4.00,False,False,False,True,60
Jordyn,2023-12-09,,Kohl's,,14.28,14.28,Gifts for Mom and Jack,,,14.28,14.28,0.00,simple,False,,expense_history_csv,Consolidated_Expense_History_20250622.csv,2025-07-18T12:32:53.413399,3.0,advanced_calculations_v3,exp_v3_000264,2023.00,12.00,4.00,False,False,False,True,60
Jordyn,2023-12-09,,Amazon,,10.77,,Jade Roller,,,10.77,,0.00,simple,False,,expense_history_csv,Consolidated_Expense_History_20250622.csv,2025-07-18T12:32:53.413399,3.0,advanced_calculations_v3,exp_v3_000265,2023.00,12.00,4.00,False,False,False,True,40
Jordyn,2023-12-09,,Gilbert Butchery,,58.80,58.80,Hanukkah Dinner,,,58.80,58.80,0.00,simple,False,,expense_history_csv,Consolidated_Expense_History_20250622.csv,2025-07-18T12:32:53.413399,3.0,advanced_calculations_v3,exp_v3_000266,2023.00,12.00,4.00,False,False,False,True,60
Jordyn,2023-12-10,,Flower Child,,52.34,52.34,Dining Out,,,52.34,52.34,0.00,simple,False,,expense_history_csv,Consolidated_Expense_History_20250622.csv,2025-07-18T12:32:53.413399,3.0,advanced_calculations_v3,exp_v3_000267,2023.00,12.00,4.00,False,False,False,True,60
Ryan,2023-11-25,Mercury,Robert's Ace Hardware,,93.89,83.55,"From previous period: ""Reassess next time (some items will be returned /refunded)"" 12/30 - $10.34 Refunded 12/14",,,93.89,83.55,6.00,complex,True,Mathematical operation: 12/30; Mathematical operation: 12/14; Mathematical operation: (some items will be returned /refunded); Manual review required: Reassess,expense_history_csv,Consolidated_Expense_History_20250622.csv,2025-07-18T12:32:53.413399,3.0,advanced_calculations_v3,exp_v3_000268,2023.00,11.00,4.00,True,False,False,True,40
Ryan,2023-12-14,Mercury,Amazon,,27.53,27.53,Six Storage Cubes,,,27.53,27.53,0.00,simple,False,,expense_history_csv,Consolidated_Expense_History_20250622.csv,2025-07-18T12:32:53.413399,3.0,advanced_calculations_v3,exp_v3_000269,2023.00,12.00,4.00,False,False,False,True,60
Ryan,2023-12-15,Mercury,Amazon,,65.15,,White Down Alternative Comforter,,,65.15,,0.00,simple,False,,expense_history_csv,Consolidated_Expense_History_20250622.csv,2025-07-18T12:32:53.413399,3.0,advanced_calculations_v3,exp_v3_000270,2023.00,12.00,4.00,False,False,False,True,40
Ryan,2023-12-17,Mercury,Amazon,,36.64,36.64,Six Storage Cubes,,,36.64,36.64,0.00,simple,False,,expense_history_csv,Consolidated_Expense_History_20250622.csv,2025-07-18T12:32:53.413399,3.0,advanced_calculations_v3,exp_v3_000271,2023.00,12.00,4.00,False,False,False,True,60
Ryan,2023-12-19,Mercury,Kindle Unlimited,,12.96,12.96,Do we keep?,,,12.96,12.96,0.00,simple,False,,expense_history_csv,Consolidated_Expense_History_20250622.csv,2025-07-18T12:32:53.413399,3.0,advanced_calculations_v3,exp_v3_000272,2023.00,12.00,4.00,False,False,False,True,60
Ryan,2023-12-20,Mercury,Staples,,9.59,,Book holder/paper weight,,,9.59,,0.00,simple,False,,expense_history_csv,Consolidated_Expense_History_20250622.csv,2025-07-18T12:32:53.413399,3.0,advanced_calculations_v3,exp_v3_000273,2023.00,12.00,4.00,False,False,False,True,40
Ryan,2023-12-21,Mercury,PlayStation Network,,2.69,2.69,Jordyn Game,,,2.69,2.69,0.00,simple,False,,expense_history_csv,Consolidated_Expense_History_20250622.csv,2025-07-18T12:32:53.413399,3.0,advanced_calculations_v3,exp_v3_000274,2023.00,12.00,4.00,False,False,False,True,60
Ryan,2023-12-21,Mercury,PlayStation Network,,4.30,4.30,Jordyn Game,,,4.30,4.30,0.00,simple,False,,expense_history_csv,Consolidated_Expense_History_20250622.csv,2025-07-18T12:32:53.413399,3.0,advanced_calculations_v3,exp_v3_000275,2023.00,12.00,4.00,False,False,False,True,60
Ryan,2023-12-21,Mercury,Amazon,,24.78,,Drug Test - Will Be Refunded,,,24.78,,0.00,simple,False,,expense_history_csv,Consolidated_Expense_History_20250622.csv,2025-07-18T12:32:53.413399,3.0,advanced_calculations_v3,exp_v3_000276,2023.00,12.00,4.00,False,False,False,True,40
Ryan,2023-12-22,Mercury,Amazon,,73.66,73.66,"Picture Frame, Back Massager (Mom Christmas Present)",,,73.66,73.66,1.00,simple,False,Mathematical operation: (Mom Christmas Present),expense_history_csv,Consolidated_Expense_History_20250622.csv,2025-07-18T12:32:53.413399,3.0,advanced_calculations_v3,exp_v3_000277,2023.00,12.00,4.00,False,False,False,True,60
Ryan,2023-12-22,Mercury,Amazon,,19.38,,Trigger Finger Splint,,,19.38,,0.00,simple,False,,expense_history_csv,Consolidated_Expense_History_20250622.csv,2025-07-18T12:32:53.413399,3.0,advanced_calculations_v3,exp_v3_000278,2023.00,12.00,4.00,False,False,False,True,40
Ryan,2023-12-22,Mercury,Amazon,,39.93,,Waterfall Fountain,,,39.93,,0.00,simple,False,,expense_history_csv,Consolidated_Expense_History_20250622.csv,2025-07-18T12:32:53.413399,3.0,advanced_calculations_v3,exp_v3_000279,2023.00,12.00,4.00,False,False,False,True,40
Ryan,2023-12-23,Mercury,Amazon,,29.92,,Trigger Finger Splint,,,29.92,,0.00,simple,False,,expense_history_csv,Consolidated_Expense_History_20250622.csv,2025-07-18T12:32:53.413399,3.0,advanced_calculations_v3,exp_v3_000280,2023.00,12.00,4.00,False,False,False,True,40
Ryan,2023-12-23,Mercury,PlayStation Network,,43.11,43.11,PSN Subscription,,,43.11,43.11,0.00,simple,False,,expense_history_csv,Consolidated_Expense_History_20250622.csv,2025-07-18T12:32:53.413399,3.0,advanced_calculations_v3,exp_v3_000281,2023.00,12.00,4.00,False,False,False,True,60
Ryan,2023-12-23,Mercury,Amazon,,9.23,,?,,,9.23,,0.00,simple,False,,expense_history_csv,Consolidated_Expense_History_20250622.csv,2025-07-18T12:32:53.413399,3.0,advanced_calculations_v3,exp_v3_000282,2023.00,12.00,4.00,False,False,False,True,40
Ryan,2023-12-25,Mercury,WHP Gift Shop,,6.50,,Jordyn Christmas Present,,,6.50,,0.00,simple,False,,expense_history_csv,Consolidated_Expense_History_20250622.csv,2025-07-18T12:32:53.413399,3.0,advanced_calculations_v3,exp_v3_000283,2023.00,12.00,4.00,False,False,False,True,40
Ryan,2023-12-26,Mercury,Harkins,,29.50,29.50,Movie,,,29.50,29.50,0.00,simple,False,,expense_history_csv,Consolidated_Expense_History_20250622.csv,2025-07-18T12:32:53.413399,3.0,advanced_calculations_v3,exp_v3_000284,2023.00,12.00,4.00,False,False,False,True,60
Ryan,2023-12-27,Mercury,Amazon,,145.41,145.41,"Coloring Book, Frame, Back Massager, Heating Pad, Picture Frame (Mom Christmas Present)",,,145.41,145.41,1.00,simple,False,Mathematical operation: (Mom Christmas Present),expense_history_csv,Consolidated_Expense_History_20250622.csv,2025-07-18T12:32:53.413399,3.0,advanced_calculations_v3,exp_v3_000285,2023.00,12.00,4.00,False,False,False,True,60
Ryan,2023-12-27,Mercury,Amazon,,9.44,,4x6 Picture Frame (Mom Christmas Present),,,9.44,,1.00,simple,False,Mathematical operation: (Mom Christmas Present),expense_history_csv,Consolidated_Expense_History_20250622.csv,2025-07-18T12:32:53.413399,3.0,advanced_calculations_v3,exp_v3_000286,2023.00,12.00,4.00,False,False,False,True,40
Ryan,2024-12-27,Mercury,Kohl's,,5.69,5.69,House Items - Autopay,,,5.69,5.69,0.00,simple,False,,expense_history_csv,Consolidated_Expense_History_20250622.csv,2025-07-18T12:32:53.413399,3.0,advanced_calculations_v3,exp_v3_000287,2024.00,12.00,4.00,False,False,False,True,60
Ryan,2024-12-30,Mercury,Amazon,,33.39,,"Scale, spray bottles",,,33.39,,0.00,simple,False,,expense_history_csv,Consolidated_Expense_History_20250622.csv,2025-07-18T12:32:53.413399,3.0,advanced_calculations_v3,exp_v3_000288,2024.00,12.00,4.00,False,False,False,True,40
Ryan,2024-12-30,Mercury,PlayStation Network,,21.34,21.34,Crash Bandicoot 4,,,21.34,21.34,0.00,simple,False,,expense_history_csv,Consolidated_Expense_History_20250622.csv,2025-07-18T12:32:53.413399,3.0,advanced_calculations_v3,exp_v3_000289,2024.00,12.00,4.00,False,False,False,True,60
Ryan,2024-12-30,Mercury,Fireworks,,4.87,4.87,Fireworks,,,4.87,4.87,0.00,simple,False,,expense_history_csv,Consolidated_Expense_History_20250622.csv,2025-07-18T12:32:53.413399,3.0,advanced_calculations_v3,exp_v3_000290,2024.00,12.00,4.00,False,False,False,True,60
Ryan,2024-12-30,Mercury,Robert's Ace Hardware,,22.82,22.82,House items,,,22.82,22.82,0.00,simple,False,,expense_history_csv,Consolidated_Expense_History_20250622.csv,2025-07-18T12:32:53.413399,3.0,advanced_calculations_v3,exp_v3_000291,2024.00,12.00,4.00,False,False,False,True,60
Ryan,2023-12-11,Capital One Savor One,The Whining,,19.92,,Food?,,,19.92,,0.00,simple,False,,expense_history_csv,Consolidated_Expense_History_20250622.csv,2025-07-18T12:32:53.413399,3.0,advanced_calculations_v3,exp_v3_000292,2023.00,12.00,4.00,False,False,False,True,40
Ryan,2023-12-12,Capital One Savor One,Fry's,,231.80,231.80,"$45,270.00",,,231.80,231.80,0.00,simple,False,,expense_history_csv,Consolidated_Expense_History_20250622.csv,2025-07-18T12:32:53.413399,3.0,advanced_calculations_v3,exp_v3_000293,2023.00,12.00,4.00,False,False,False,True,60
Ryan,2023-12-16,Capital One Savor One,Whole Foods Market,,29.08,29.08,Unable to itemize,,,29.08,29.08,0.00,simple,False,,expense_history_csv,Consolidated_Expense_History_20250622.csv,2025-07-18T12:32:53.413399,3.0,advanced_calculations_v3,exp_v3_000294,2023.00,12.00,4.00,False,False,False,True,60
Ryan,2023-12-18,Capital One Savor One,Fry's,,36.94,36.94,"Aquafina, Tito's",,,36.94,36.94,0.00,simple,False,,expense_history_csv,Consolidated_Expense_History_20250622.csv,2025-07-18T12:32:53.413399,3.0,advanced_calculations_v3,exp_v3_000295,2023.00,12.00,4.00,False,False,False,True,60
Ryan,2023-12-18,Capital One Savor One,Uber,,34.08,34.08,A R I Z O N A Concert,,,34.08,34.08,0.00,simple,False,,expense_history_csv,Consolidated_Expense_History_20250622.csv,2025-07-18T12:32:53.413399,3.0,advanced_calculations_v3,exp_v3_000296,2023.00,12.00,4.00,False,False,False,True,60
Ryan,2023-12-18,Capital One Savor One,The Van Buren,,21.60,21.60,A R I Z O N A Concert,,,21.60,21.60,0.00,simple,False,,expense_history_csv,Consolidated_Expense_History_20250622.csv,2025-07-18T12:32:53.413399,3.0,advanced_calculations_v3,exp_v3_000297,2023.00,12.00,4.00,False,False,False,True,60
Ryan,2023-12-18,Capital One Savor One,Uber,,31.84,31.84,A R I Z O N A Concert (Additional tip was removed),,,31.84,31.84,5.00,exclusion_adjustment,False,Mathematical operation: (Additional tip was removed); Exclusion adjustment: removed); Exclusion adjustment: removed),expense_history_csv,Consolidated_Expense_History_20250622.csv,2025-07-18T12:32:53.413399,3.0,advanced_calculations_v3,exp_v3_000298,2023.00,12.00,4.00,True,True,False,True,60
Ryan,2023-12-18,Capital One Savor One,Uber Driver Tip,,100.00,100.00,A R I Z O N A Concert (Paid to ensure he would help find Jordyn and get her home safely),,,100.00,100.00,1.00,simple,False,Mathematical operation: (Paid to ensure he would help find Jordyn and get her home safely),expense_history_csv,Consolidated_Expense_History_20250622.csv,2025-07-18T12:32:53.413399,3.0,advanced_calculations_v3,exp_v3_000299,2023.00,12.00,4.00,False,False,False,True,60
Ryan,2023-12-21,Capital One Savor One,Whole Foods Market,,38.42,38.42,Unable to itemize,,,38.42,38.42,0.00,simple,False,,expense_history_csv,Consolidated_Expense_History_20250622.csv,2025-07-18T12:32:53.413399,3.0,advanced_calculations_v3,exp_v3_000300,2023.00,12.00,4.00,False,False,False,True,60
Ryan,2023-12-26,Capital One Savor One,Safeway,,46.20,46.20,Unable to itemize,,,46.20,46.20,0.00,simple,False,,expense_history_csv,Consolidated_Expense_History_20250622.csv,2025-07-18T12:32:53.413399,3.0,advanced_calculations_v3,exp_v3_000301,2023.00,12.00,4.00,False,False,False,True,60
Ryan,2023-12-26,Capital One Savor One,Fry's,,154.73,154.73,"$45,284.00",,,154.73,154.73,0.00,simple,False,,expense_history_csv,Consolidated_Expense_History_20250622.csv,2025-07-18T12:32:53.413399,3.0,advanced_calculations_v3,exp_v3_000302,2023.00,12.00,4.00,False,False,False,True,60
Ryan,2023-12-26,Capital One Savor One,Ryu Sushi,,40.81,40.81,Dinner,,,40.81,40.81,0.00,simple,False,,expense_history_csv,Consolidated_Expense_History_20250622.csv,2025-07-18T12:32:53.413399,3.0,advanced_calculations_v3,exp_v3_000303,2023.00,12.00,4.00,False,False,False,True,60
Ryan,2023-12-26,Capital One Savor One,Target,,8.61,,Gum,,,8.61,,0.00,simple,False,,expense_history_csv,Consolidated_Expense_History_20250622.csv,2025-07-18T12:32:53.413399,3.0,advanced_calculations_v3,exp_v3_000304,2023.00,12.00,4.00,False,False,False,True,40
Ryan,2023-12-26,Capital One Savor One,Walmart,,39.96,,Fuel,,,39.96,,0.00,simple,False,,expense_history_csv,Consolidated_Expense_History_20250622.csv,2025-07-18T12:32:53.413399,3.0,advanced_calculations_v3,exp_v3_000305,2023.00,12.00,4.00,False,False,False,True,40
Ryan,2023-12-26,Capital One Savor One,Gus's Fried Chicken,,32.20,32.20,Dinner,,,32.20,32.20,0.00,simple,False,,expense_history_csv,Consolidated_Expense_History_20250622.csv,2025-07-18T12:32:53.413399,3.0,advanced_calculations_v3,exp_v3_000306,2023.00,12.00,4.00,False,False,False,True,60
Ryan,2023-12-27,Capital One Savor One,Ling & Louie's,,31.00,31.00,Dinner,,,31.00,31.00,0.00,simple,False,,expense_history_csv,Consolidated_Expense_History_20250622.csv,2025-07-18T12:32:53.413399,3.0,advanced_calculations_v3,exp_v3_000307,2023.00,12.00,4.00,False,False,False,True,60
Ryan,2023-12-27,Capital One Savor One,The UPS Store,,8.82,,Box to Ship Back Comforter (Amazon Return),,,8.82,,1.00,simple,False,Mathematical operation: (Amazon Return),expense_history_csv,Consolidated_Expense_History_20250622.csv,2025-07-18T12:32:53.413399,3.0,advanced_calculations_v3,exp_v3_000308,2023.00,12.00,4.00,False,False,False,True,40
Ryan,2023-12-27,Capital One Savor One,Harkins,,28.00,28.00,Wine,,,28.00,28.00,0.00,simple,False,,expense_history_csv,Consolidated_Expense_History_20250622.csv,2025-07-18T12:32:53.413399,3.0,advanced_calculations_v3,exp_v3_000309,2023.00,12.00,4.00,False,False,False,True,60
Ryan,2023-12-27,Capital One Savor One,Harkins,,33.00,33.00,Wine,,,33.00,33.00,0.00,simple,False,,expense_history_csv,Consolidated_Expense_History_20250622.csv,2025-07-18T12:32:53.413399,3.0,advanced_calculations_v3,exp_v3_000310,2023.00,12.00,4.00,False,False,False,True,60
Ryan,2024-12-29,Capital One Savor One,Whole Foods Market,,15.51,15.51,"Tea, etc.",,,15.51,15.51,0.00,simple,False,,expense_history_csv,Consolidated_Expense_History_20250622.csv,2025-07-18T12:32:53.413399,3.0,advanced_calculations_v3,exp_v3_000311,2024.00,12.00,4.00,False,False,False,True,60
Ryan,2024-12-30,Capital One Savor One,Fry's,,45.49,45.49,"Pizza, wine, etc.",,,45.49,45.49,0.00,simple,False,,expense_history_csv,Consolidated_Expense_History_20250622.csv,2025-07-18T12:32:53.413399,3.0,advanced_calculations_v3,exp_v3_000312,2024.00,12.00,4.00,False,False,False,True,60
Ryan,2024-12-31,Capital One Savor One,Walmart,,75.95,75.95,"Ladder, etc.",,,75.95,75.95,0.00,simple,False,,expense_history_csv,Consolidated_Expense_History_20250622.csv,2025-07-18T12:32:53.413399,3.0,advanced_calculations_v3,exp_v3_000313,2024.00,12.00,4.00,False,False,False,True,60
Ryan,2023-12-18,Capital One Walmart,Walmart,,13.99,13.99,Unknown,,,13.99,13.99,0.00,simple,False,,expense_history_csv,Consolidated_Expense_History_20250622.csv,2025-07-18T12:32:53.413399,3.0,advanced_calculations_v3,exp_v3_000314,2023.00,12.00,4.00,False,False,False,True,60
Ryan,2023-12-19,Capital One Walmart,Walmart,,76.79,35.00,"Goo Gone, Swiffer Power Mop, Sexy Outfit, Trigger Finger Splint, 3M Drywall Hanger (Remove outfit and splint)",,,76.79,35.00,5.00,exclusion_adjustment,False,Mathematical operation: (Remove outfit and splint); Exclusion adjustment: Remove outfit and splint); Exclusion adjustment: Remove outfit and splint),expense_history_csv,Consolidated_Expense_History_20250622.csv,2025-07-18T12:32:53.413399,3.0,advanced_calculations_v3,exp_v3_000315,2023.00,12.00,4.00,True,True,False,True,60
Ryan,2023-12-24,Credit One x 1559,Amazon,,15.98,,"Busch Light Sign, No Salt Seasoning",,,15.98,,0.00,simple,False,,expense_history_csv,Consolidated_Expense_History_20250622.csv,2025-07-18T12:32:53.413399,3.0,advanced_calculations_v3,exp_v3_000316,2023.00,12.00,4.00,False,False,False,True,40
Ryan,2023-12-28,Credit One x 1559,Amazon,,37.79,,"Busch Light Sign, No Salt Seasoning",,,37.79,,0.00,simple,False,,expense_history_csv,Consolidated_Expense_History_20250622.csv,2025-07-18T12:32:53.413399,3.0,advanced_calculations_v3,exp_v3_000317,2023.00,12.00,4.00,False,False,False,True,40
Ryan,2023-11-19,Credit One x 6396,Target,,46.99,,Omitted from above,,,46.99,,0.00,simple,False,,expense_history_csv,Consolidated_Expense_History_20250622.csv,2025-07-18T12:32:53.413399,3.0,advanced_calculations_v3,exp_v3_000318,2023.00,11.00,4.00,False,False,False,True,40
Ryan,2023-11-21,Credit One x 6396,Fry's,,92.96,19.99,"Incorrectly listed as ""0"" above. - Upon looking further, only Vizzy is applicable.",,,92.96,19.99,0.00,simple,False,,expense_history_csv,Consolidated_Expense_History_20250622.csv,2025-07-18T12:32:53.413399,3.0,advanced_calculations_v3,exp_v3_000319,2023.00,11.00,4.00,False,False,False,True,60
Ryan,2023-12-13,Credit One x 6396,Whole Foods Market,,34.47,34.47,Unable to itemize,,,34.47,34.47,0.00,simple,False,,expense_history_csv,Consolidated_Expense_History_20250622.csv,2025-07-18T12:32:53.413399,3.0,advanced_calculations_v3,exp_v3_000320,2023.00,12.00,4.00,False,False,False,True,60
Ryan,2023-12-13,Credit One x 6396,Robert's Ace Hardware,,1.98,1.98,House Items,,,1.98,1.98,0.00,simple,False,,expense_history_csv,Consolidated_Expense_History_20250622.csv,2025-07-18T12:32:53.413399,3.0,advanced_calculations_v3,exp_v3_000321,2023.00,12.00,4.00,False,False,False,True,60
Ryan,2023-12-14,Credit One x 6396,Fry's,,25.85,25.31,"Chobani, Mustard, Lemon, Pepperoni, Artichoke Hearts",,,25.85,25.31,0.00,simple,False,,expense_history_csv,Consolidated_Expense_History_20250622.csv,2025-07-18T12:32:53.413399,3.0,advanced_calculations_v3,exp_v3_000322,2023.00,12.00,4.00,False,False,False,True,60
Ryan,2024-12-27,Credit One x 6397,Fry's,,26.67,,Possibly fuel,,,26.67,,0.00,simple,False,,expense_history_csv,Consolidated_Expense_History_20250622.csv,2025-07-18T12:32:53.413399,3.0,advanced_calculations_v3,exp_v3_000323,2024.00,12.00,4.00,False,False,False,True,40
Ryan,2024-12-27,Credit One x 6398,Fry's,,9.64,9.64,Seltzers,,,9.64,9.64,0.00,simple,False,,expense_history_csv,Consolidated_Expense_History_20250622.csv,2025-07-18T12:32:53.413399,3.0,advanced_calculations_v3,exp_v3_000324,2024.00,12.00,4.00,False,False,False,True,60
Ryan,2023-12-13,Wells Fargo Autograph,Fry's,,25.85,,Pan (Returned),,,25.85,,1.00,simple,False,Mathematical operation: (Returned),expense_history_csv,Consolidated_Expense_History_20250622.csv,2025-07-18T12:32:53.413399,3.0,advanced_calculations_v3,exp_v3_000325,2023.00,12.00,4.00,False,False,False,True,40
Ryan,2023-12-14,Wells Fargo Autograph,Fry's,,48.56,48.56,"Batteries, Wine",,,48.56,48.56,0.00,simple,False,,expense_history_csv,Consolidated_Expense_History_20250622.csv,2025-07-18T12:32:53.413399,3.0,advanced_calculations_v3,exp_v3_000326,2023.00,12.00,4.00,False,False,False,True,60
Ryan,2023-12-15,Wells Fargo Autograph,Chon Thai,,19.22,19.22,Dinner,,,19.22,19.22,0.00,simple,False,,expense_history_csv,Consolidated_Expense_History_20250622.csv,2025-07-18T12:32:53.413399,3.0,advanced_calculations_v3,exp_v3_000327,2023.00,12.00,4.00,False,False,False,True,60
Ryan,2023-12-16,Wells Fargo Autograph,Ziggy's Pizza,,23.00,23.00,Dinner,,,23.00,23.00,0.00,simple,False,,expense_history_csv,Consolidated_Expense_History_20250622.csv,2025-07-18T12:32:53.413399,3.0,advanced_calculations_v3,exp_v3_000328,2023.00,12.00,4.00,False,False,False,True,60
Ryan,2023-12-16,Wells Fargo Autograph,The Van Buren Phoenix,,20.70,20.70,A R I Z O N A Concert,,,20.70,20.70,0.00,simple,False,,expense_history_csv,Consolidated_Expense_History_20250622.csv,2025-07-18T12:32:53.413399,3.0,advanced_calculations_v3,exp_v3_000329,2023.00,12.00,4.00,False,False,False,True,60
Ryan,2023-12-16,Wells Fargo Autograph,The Van Buren Phoenix,,41.40,,A R I Z O N A Concert,,,41.40,,0.00,simple,False,,expense_history_csv,Consolidated_Expense_History_20250622.csv,2025-07-18T12:32:53.413399,3.0,advanced_calculations_v3,exp_v3_000330,2023.00,12.00,4.00,False,False,False,True,40
Ryan,2023-12-16,Wells Fargo Autograph,The Van Buren Phoenix,,39.00,,A R I Z O N A Concert,,,39.00,,0.00,simple,False,,expense_history_csv,Consolidated_Expense_History_20250622.csv,2025-07-18T12:32:53.413399,3.0,advanced_calculations_v3,exp_v3_000331,2023.00,12.00,4.00,False,False,False,True,40
Ryan,2023-12-16,Wells Fargo Autograph,The Van Buren Phoenix,,21.60,,A R I Z O N A Concert,,,21.60,,0.00,simple,False,,expense_history_csv,Consolidated_Expense_History_20250622.csv,2025-07-18T12:32:53.413399,3.0,advanced_calculations_v3,exp_v3_000332,2023.00,12.00,4.00,False,False,False,True,40
Ryan,2023-12-17,Wells Fargo Autograph,Culver's,,23.97,23.97,Dinner,,,23.97,23.97,0.00,simple,False,,expense_history_csv,Consolidated_Expense_History_20250622.csv,2025-07-18T12:32:53.413399,3.0,advanced_calculations_v3,exp_v3_000333,2023.00,12.00,4.00,False,False,False,True,60
Ryan,2023-12-29,Target RedCard,Target,,10.12,10.12,"Baking sheets, Acetone, Clue, Fork",,,10.12,10.12,0.00,simple,False,,expense_history_csv,Consolidated_Expense_History_20250622.csv,2025-07-18T12:32:53.413399,3.0,advanced_calculations_v3,exp_v3_000334,2023.00,12.00,4.00,False,False,False,True,60
Ryan,2023-12-30,Target RedCard,Target,,30.71,30.71,Spice Rack,,,30.71,30.71,0.00,simple,False,,expense_history_csv,Consolidated_Expense_History_20250622.csv,2025-07-18T12:32:53.413399,3.0,advanced_calculations_v3,exp_v3_000335,2023.00,12.00,4.00,False,False,False,True,60
Ryan,2023-12-30,Target RedCard,Target,,71.68,71.68,Plates,,,71.68,71.68,0.00,simple,False,,expense_history_csv,Consolidated_Expense_History_20250622.csv,2025-07-18T12:32:53.413399,3.0,advanced_calculations_v3,exp_v3_000336,2023.00,12.00,4.00,False,False,False,True,60
Ryan,2023-12-30,Target RedCard,Target,,29.73,4.73,"Dawn, Tide, Cheese Grater, Cards, Windex, Bounty ($25 Credit)",,,29.73,4.73,1.00,simple,False,Mathematical operation: ($25 Credit),expense_history_csv,Consolidated_Expense_History_20250622.csv,2025-07-18T12:32:53.413399,3.0,advanced_calculations_v3,exp_v3_000337,2023.00,12.00,4.00,False,False,False,True,60
Ryan,2023-12-30,Target RedCard,Target,,16.39,16.39,Four Forks,,,16.39,16.39,0.00,simple,False,,expense_history_csv,Consolidated_Expense_History_20250622.csv,2025-07-18T12:32:53.413399,3.0,advanced_calculations_v3,exp_v3_000338,2023.00,12.00,4.00,False,False,False,True,60
Ryan,2023-12-15,Apple Pay,Bro,,250.00,250.00,,,,250.00,250.00,0.00,simple,False,,expense_history_csv,Consolidated_Expense_History_20250622.csv,2025-07-18T12:32:53.413399,3.0,advanced_calculations_v3,exp_v3_000339,2023.00,12.00,4.00,False,False,False,True,40
Ryan,2023-12-23,Apple Pay,Bro,,80.00,80.00,,,,80.00,80.00,0.00,simple,False,,expense_history_csv,Consolidated_Expense_History_20250622.csv,2025-07-18T12:32:53.413399,3.0,advanced_calculations_v3,exp_v3_000340,2023.00,12.00,4.00,False,False,False,True,40
Ryan,2023-12-29,Apple Pay,Bro,,225.00,225.00,,,,225.00,225.00,0.00,simple,False,,expense_history_csv,Consolidated_Expense_History_20250622.csv,2025-07-18T12:32:53.413399,3.0,advanced_calculations_v3,exp_v3_000341,2023.00,12.00,4.00,False,False,False,True,40
Ryan,2023-12-21,Cash,Rebecca,,80.00,,,,,80.00,,0.00,simple,False,,expense_history_csv,Consolidated_Expense_History_20250622.csv,2025-07-18T12:32:53.413399,3.0,advanced_calculations_v3,exp_v3_000342,2023.00,12.00,4.00,False,False,False,True,20
Ryan,2023-12-22,Cash,Rebecca,,80.00,,,,,80.00,,0.00,simple,False,,expense_history_csv,Consolidated_Expense_History_20250622.csv,2025-07-18T12:32:53.413399,3.0,advanced_calculations_v3,exp_v3_000343,2023.00,12.00,4.00,False,False,False,True,20
Ryan,2023-12-23,Cash,Rebecca,,220.00,220.00,Lost (I will take half the financial burden as a sign of good faith),,,220.00,220.00,4.00,complex,True,Mathematical operation: (I will take half the financial burden as a sign of good faith); Manual review required: Lost,expense_history_csv,Consolidated_Expense_History_20250622.csv,2025-07-18T12:32:53.413399,3.0,advanced_calculations_v3,exp_v3_000344,2023.00,12.00,4.00,True,False,False,True,40
Ryan,2023-12-28,Cash,Rebecca,,80.00,80.00,,,,80.00,80.00,0.00,simple,False,,expense_history_csv,Consolidated_Expense_History_20250622.csv,2025-07-18T12:32:53.413399,3.0,advanced_calculations_v3,exp_v3_000345,2023.00,12.00,4.00,False,False,False,True,40
Ryan,2023-12-29,Cash,Rebecca,,80.00,80.00,,,,80.00,80.00,0.00,simple,False,,expense_history_csv,Consolidated_Expense_History_20250622.csv,2025-07-18T12:32:53.413399,3.0,advanced_calculations_v3,exp_v3_000346,2023.00,12.00,4.00,False,False,False,True,40
Ryan,2024-12-31,Cash,Rebecca,,225.00,,,,,225.00,,0.00,simple,False,,expense_history_csv,Consolidated_Expense_History_20250622.csv,2025-07-18T12:32:53.413399,3.0,advanced_calculations_v3,exp_v3_000347,2024.00,12.00,4.00,False,False,False,True,20
Ryan,,Cash,Bro (Xan),,70.00,50.00,Lost (I will take half the financial burden as a sign of good faith),,,70.00,50.00,4.00,complex,True,Mathematical operation: (I will take half the financial burden as a sign of good faith); Manual review required: Lost,expense_history_csv,Consolidated_Expense_History_20250622.csv,2025-07-18T12:32:53.413399,3.0,advanced_calculations_v3,exp_v3_000348,,,,True,False,False,False,0
Ryan,,Amazon,Amazon Gift Card,,50.00,,"From previous period: ""Reassess next time"". 12/30 - Very difficult to determine who used what.",,,50.00,,7.00,complex,True,Mathematical operation: 12/30; Manual review required: Reassess; Manual review required: Very difficult,expense_history_csv,Consolidated_Expense_History_20250622.csv,2025-07-18T12:32:53.413399,3.0,advanced_calculations_v3,exp_v3_000349,,,,True,False,False,False,-20
Jordyn,2024-12-11,,Fry's,,16.93,16.93,,,,16.93,16.93,0.00,simple,False,,expense_history_csv,Consolidated_Expense_History_20250622.csv,2025-07-18T12:32:53.413399,3.0,advanced_calculations_v3,exp_v3_000350,2024.00,12.00,4.00,False,False,False,True,40
Jordyn,2024-12-12,,Fry's,,25.31,25.31,Food,,,25.31,25.31,0.00,simple,False,,expense_history_csv,Consolidated_Expense_History_20250622.csv,2025-07-18T12:32:53.413399,3.0,advanced_calculations_v3,exp_v3_000351,2024.00,12.00,4.00,False,False,False,True,60
Jordyn,2024-12-12,,Walmart,,9.09,9.09,Pizza,,,9.09,9.09,0.00,simple,False,,expense_history_csv,Consolidated_Expense_History_20250622.csv,2025-07-18T12:32:53.413399,3.0,advanced_calculations_v3,exp_v3_000352,2024.00,12.00,4.00,False,False,False,True,60
Jordyn,2024-12-15,,Twin Thai,,19.22,19.22,,,,19.22,19.22,0.00,simple,False,,expense_history_csv,Consolidated_Expense_History_20250622.csv,2025-07-18T12:32:53.413399,3.0,advanced_calculations_v3,exp_v3_000353,2024.00,12.00,4.00,False,False,False,True,40
Jordyn,2024-12-17,,Amazon,,33.41,,Probiotics,,,33.41,,0.00,simple,False,,expense_history_csv,Consolidated_Expense_History_20250622.csv,2025-07-18T12:32:53.413399,3.0,advanced_calculations_v3,exp_v3_000354,2024.00,12.00,4.00,False,False,False,True,40
Jordyn,2024-12-19,,Sprouts,,79.87,79.87,Food,,,79.87,79.87,0.00,simple,False,,expense_history_csv,Consolidated_Expense_History_20250622.csv,2025-07-18T12:32:53.413399,3.0,advanced_calculations_v3,exp_v3_000355,2024.00,12.00,4.00,False,False,False,True,60
Jordyn,2024-12-22,,Ryu Sushi,,42.82,42.82,,,,42.82,42.82,0.00,simple,False,,expense_history_csv,Consolidated_Expense_History_20250622.csv,2025-07-18T12:32:53.413399,3.0,advanced_calculations_v3,exp_v3_000356,2024.00,12.00,4.00,False,False,False,True,40
Jordyn,2024-12-22,,Whole Foods Market,,31.75,31.75,,,,31.75,31.75,0.00,simple,False,,expense_history_csv,Consolidated_Expense_History_20250622.csv,2025-07-18T12:32:53.413399,3.0,advanced_calculations_v3,exp_v3_000357,2024.00,12.00,4.00,False,False,False,True,40
Jordyn,2024-12-23,,Gus's Fried Chicken,,32.20,32.20,,,,32.20,32.20,0.00,simple,False,,expense_history_csv,Consolidated_Expense_History_20250622.csv,2025-07-18T12:32:53.413399,3.0,advanced_calculations_v3,exp_v3_000358,2024.00,12.00,4.00,False,False,False,True,40
Jordyn,2024-12-25,,Harkin's,,9.00,9.00,,,,9.00,9.00,0.00,simple,False,,expense_history_csv,Consolidated_Expense_History_20250622.csv,2025-07-18T12:32:53.413399,3.0,advanced_calculations_v3,exp_v3_000359,2024.00,12.00,4.00,False,False,False,True,40
Jordyn,2024-12-26,,Ling & Louie's,,105.00,105.00,,,,105.00,105.00,0.00,simple,False,,expense_history_csv,Consolidated_Expense_History_20250622.csv,2025-07-18T12:32:53.413399,3.0,advanced_calculations_v3,exp_v3_000360,2024.00,12.00,4.00,False,False,False,True,40
Jordyn,2024-12-28,,Thirsty Lion,,73.75,73.75,,,,73.75,73.75,0.00,simple,False,,expense_history_csv,Consolidated_Expense_History_20250622.csv,2025-07-18T12:32:53.413399,3.0,advanced_calculations_v3,exp_v3_000361,2024.00,12.00,4.00,False,False,False,True,40
Jordyn,2024-12-29,,Sneaky Bird,,24.36,24.36,,,,24.36,24.36,0.00,simple,False,,expense_history_csv,Consolidated_Expense_History_20250622.csv,2025-07-18T12:32:53.413399,3.0,advanced_calculations_v3,exp_v3_000362,2024.00,12.00,4.00,False,False,False,True,40
Jordyn,2024-12-30,,Dollar Tree,,9.43,9.43,,,,9.43,9.43,0.00,simple,False,,expense_history_csv,Consolidated_Expense_History_20250622.csv,2025-07-18T12:32:53.413399,3.0,advanced_calculations_v3,exp_v3_000363,2024.00,12.00,4.00,False,False,False,True,40
Jordyn,2024-12-30,,Fry's,,176.88,176.88,,,,176.88,176.88,0.00,simple,False,,expense_history_csv,Consolidated_Expense_History_20250622.csv,2025-07-18T12:32:53.413399,3.0,advanced_calculations_v3,exp_v3_000364,2024.00,12.00,4.00,False,False,False,True,40
Ryan,2024-01-03,Mercury,Amazon,,8.07,8.07,Prime student fee?? Why is this on Mercury x4893?,,,8.07,8.07,0.00,simple,False,,expense_history_csv,Consolidated_Expense_History_20250622.csv,2025-07-18T12:32:53.413399,3.0,advanced_calculations_v3,exp_v3_000365,2024.00,1.00,1.00,False,False,False,True,60
Ryan,2024-01-04,Mercury,Amazon,,114.57,,"Knee massager, eufy Scale, Lunix hand massager, etc.",,,114.57,,0.00,simple,False,,expense_history_csv,Consolidated_Expense_History_20250622.csv,2025-07-18T12:32:53.413399,3.0,advanced_calculations_v3,exp_v3_000366,2024.00,1.00,1.00,False,False,False,True,40
Ryan,2024-01-04,Mercury,Amazon,,24.78,,Mouse Mover,,,24.78,,0.00,simple,False,,expense_history_csv,Consolidated_Expense_History_20250622.csv,2025-07-18T12:32:53.413399,3.0,advanced_calculations_v3,exp_v3_000367,2024.00,1.00,1.00,False,False,False,True,40
Ryan,2024-01-08,Mercury,Prime Video,,6.46,,Oppenheimer Movie,,,6.46,,0.00,simple,False,,expense_history_csv,Consolidated_Expense_History_20250622.csv,2025-07-18T12:32:53.413399,3.0,advanced_calculations_v3,exp_v3_000368,2024.00,1.00,1.00,False,False,False,True,40
Ryan,2024-01-11,Mercury,Amazon,,52.82,,Kindle,,,52.82,,0.00,simple,False,,expense_history_csv,Consolidated_Expense_History_20250622.csv,2025-07-18T12:32:53.413399,3.0,advanced_calculations_v3,exp_v3_000369,2024.00,1.00,1.00,False,False,False,True,40
Ryan,2024-01-11,Mercury,Fry's,,74.08,,,,,74.08,,0.00,simple,False,,expense_history_csv,Consolidated_Expense_History_20250622.csv,2025-07-18T12:32:53.413399,3.0,advanced_calculations_v3,exp_v3_000370,2024.00,1.00,1.00,False,False,False,True,20
Ryan,2024-01-14,Mercury,Prime Video,,12.93,,"Paramount+ with SHOWTIME (How did this get passed my Subscriptions lists?) Did Jordyn order, do we want to keep?",,,12.93,,4.00,complex,True,Mathematical operation: (How did this get passed my Subscriptions lists?); Manual review required: Did Jordyn order,expense_history_csv,Consolidated_Expense_History_20250622.csv,2025-07-18T12:32:53.413399,3.0,advanced_calculations_v3,exp_v3_000371,2024.00,1.00,1.00,True,False,False,True,20
Ryan,2024-01-16,Mercury,Amazon,,73.75,,"Acetaminophen, Ibuprofen, TheraTeras Dry Eye  (74.38 + 2.99 - 2.35 - 1.56 - 2.99 - 2.40 - 68.07. + 5.68 = 73.75). Deduct $23.12 for ThereaTeras Dry Eye",,,73.75,,9.00,exclusion_adjustment,False,Mathematical operation: 74.38 + 2.99; Mathematical operation: 07. + 5.68; Mathematical operation: 2.99 - 2.35; Mathematical operation: 1.56 - 2.99; Mathematical operation: 2.40 - 68.07; Mathematical operation: (74.38 + 2.99 - 2.35 - 1.56 - 2.99 - 2.40 - 68.07. + 5.68 = 73.75); Mathematical operation: = 73.75; Exclusion adjustment: Deduct $23.12,expense_history_csv,Consolidated_Expense_History_20250622.csv,2025-07-18T12:32:53.413399,3.0,advanced_calculations_v3,exp_v3_000372,2024.00,1.00,1.00,True,True,False,True,40
Ryan,2024-01-19,Mercury,Amazon,,11.20,,Triamcinolone Nasal Allergy Spray,,,11.20,,0.00,simple,False,,expense_history_csv,Consolidated_Expense_History_20250622.csv,2025-07-18T12:32:53.413399,3.0,advanced_calculations_v3,exp_v3_000373,2024.00,1.00,1.00,False,False,False,True,40
Ryan,2024-01-20,Mercury,Amazon,,8.07,,Mothers PowerPlastic 4Lights (Monitor Scratch),,,8.07,,4.00,complex,True,Mathematical operation: (Monitor Scratch); Manual review required: Monitor,expense_history_csv,Consolidated_Expense_History_20250622.csv,2025-07-18T12:32:53.413399,3.0,advanced_calculations_v3,exp_v3_000374,2024.00,1.00,1.00,True,False,False,True,20
Ryan,2024-01-21,Mercury,Amazon,,199.81,,"BACtrack (123.87), Exercise devices.  Order# 113-3583335-6728210",,,199.81,,2.00,simple,False,Mathematical operation: 113-3583335; Mathematical operation: (123.87),expense_history_csv,Consolidated_Expense_History_20250622.csv,2025-07-18T12:32:53.413399,3.0,advanced_calculations_v3,exp_v3_000375,2024.00,1.00,1.00,False,False,False,True,40
Ryan,2024-01-27,Mercury,Amazon,,40.95,11.53,"Reading PIllow (Free for Jordyn from Ryan as a present, heart emoji), touch-toe stopper (11.53) Order# 113-3380358-9555412",,,40.95,11.53,4.00,gift_present,False,"Gift/present allocation: Free for Jordyn from Ryan as a present; Mathematical operation: 113-3380358; Mathematical operation: (Free for Jordyn from Ryan as a present, heart emoji); Mathematical operation: (11.53)",expense_history_csv,Consolidated_Expense_History_20250622.csv,2025-07-18T12:32:53.413399,3.0,advanced_calculations_v3,exp_v3_000376,2024.00,1.00,1.00,True,True,False,True,60
Ryan,2024-01-28,Mercury,Whole Foods,,44.18,44.18,$44.18,,,44.18,44.18,0.00,simple,False,,expense_history_csv,Consolidated_Expense_History_20250622.csv,2025-07-18T12:32:53.413399,3.0,advanced_calculations_v3,exp_v3_000377,2024.00,1.00,1.00,False,False,False,True,60
Ryan,2024-01-28,Mercury,Ace Hardware,,34.98,34.98,Household Items,,,34.98,34.98,0.00,simple,False,,expense_history_csv,Consolidated_Expense_History_20250622.csv,2025-07-18T12:32:53.413399,3.0,advanced_calculations_v3,exp_v3_000378,2024.00,1.00,1.00,False,False,False,True,60
Ryan,2024-01-29,Mercury,Amazon,,42.02,,"Zip Ties, Wood Squatting Toilet (Ryan 100%)",,,42.02,,3.00,gift_present,False,Contains percentage allocation: Ryan 100%; Gift/present allocation: Ryan 100%; Mathematical operation: (Ryan 100%),expense_history_csv,Consolidated_Expense_History_20250622.csv,2025-07-18T12:32:53.413399,3.0,advanced_calculations_v3,exp_v3_000379,2024.00,1.00,1.00,True,True,False,True,40
Ryan,2024-01-29,Mercury,UPS Store,,20.24,20.24,Box for Air Mattress Return,,,20.24,20.24,0.00,simple,False,,expense_history_csv,Consolidated_Expense_History_20250622.csv,2025-07-18T12:32:53.413399,3.0,advanced_calculations_v3,exp_v3_000380,2024.00,1.00,1.00,False,False,False,True,60
Ryan,2024-02-02,Mercury,Barnes & Noble,,64.66,,Ryan Purchases,,,64.66,,0.00,simple,False,,expense_history_csv,Consolidated_Expense_History_20250622.csv,2025-07-18T12:32:53.413399,3.0,advanced_calculations_v3,exp_v3_000381,2024.00,2.00,1.00,False,False,False,True,40
Ryan,2024-02-03,Mercury,Amazon,,83.98,,"LetsGetChecked, Breather Fit, L-Serine, Spermcheck (Order# 113-1499724-0624207)",,,83.98,,2.00,simple,False,Mathematical operation: 113-1499724; Mathematical operation: (Order# 113-1499724-0624207),expense_history_csv,Consolidated_Expense_History_20250622.csv,2025-07-18T12:32:53.413399,3.0,advanced_calculations_v3,exp_v3_000382,2024.00,2.00,1.00,False,False,False,True,40
Ryan,2024-02-04,Mercury,Amazon,,35.71,35.71,Cord Cover Raceway Kit. If this is returned pay Jordyn,,,35.71,35.71,0.00,simple,False,,expense_history_csv,Consolidated_Expense_History_20250622.csv,2025-07-18T12:32:53.413399,3.0,advanced_calculations_v3,exp_v3_000383,2024.00,2.00,1.00,False,False,False,True,60
Ryan,2024-02-04,Mercury,Amazon,,10.77,10.77,Levoit Water Filter,,,10.77,10.77,0.00,simple,False,,expense_history_csv,Consolidated_Expense_History_20250622.csv,2025-07-18T12:32:53.413399,3.0,advanced_calculations_v3,exp_v3_000384,2024.00,2.00,1.00,False,False,False,True,60
Ryan,2024-02-04,Mercury,Amazon,,89.70,,"D-Line Cord Hider Kit, Legrand Cable Management Kit",,,89.70,,0.00,simple,False,,expense_history_csv,Consolidated_Expense_History_20250622.csv,2025-07-18T12:32:53.413399,3.0,advanced_calculations_v3,exp_v3_000385,2024.00,2.00,1.00,False,False,False,True,40
Ryan,2024-02-04,Mercury,Ace Hardware,,121.34,121.34,"Household Items (Drill, Lightbulbs, etc.)",,,121.34,121.34,1.00,simple,False,"Mathematical operation: (Drill, Lightbulbs, etc.)",expense_history_csv,Consolidated_Expense_History_20250622.csv,2025-07-18T12:32:53.413399,3.0,advanced_calculations_v3,exp_v3_000386,2024.00,2.00,1.00,False,False,False,True,60
Ryan,2024-02-05,Mercury,Amazon,,10.55,10.55,Zinc Self Drilling Anchors (Order# 111-6450316-5362616),,,10.55,10.55,2.00,simple,False,Mathematical operation: 111-6450316; Mathematical operation: (Order# 111-6450316-5362616),expense_history_csv,Consolidated_Expense_History_20250622.csv,2025-07-18T12:32:53.413399,3.0,advanced_calculations_v3,exp_v3_000387,2024.00,2.00,1.00,False,False,False,True,60
Ryan,2024-02-05,Mercury,Costco,,128.52,128.52,Annual Membership,,,128.52,128.52,0.00,simple,False,,expense_history_csv,Consolidated_Expense_History_20250622.csv,2025-07-18T12:32:53.413399,3.0,advanced_calculations_v3,exp_v3_000388,2024.00,2.00,1.00,False,False,False,True,60
Ryan,2024-02-05,Mercury,Best Buy,,100.00,,MacBook Down Payment,,,100.00,,0.00,simple,False,,expense_history_csv,Consolidated_Expense_History_20250622.csv,2025-07-18T12:32:53.413399,3.0,advanced_calculations_v3,exp_v3_000389,2024.00,2.00,1.00,False,False,False,True,40
Ryan,2024-02-06,Mercury,Amazon,,32.76,32.76,Scale / Amber Glass,,,32.76,32.76,0.00,simple,False,,expense_history_csv,Consolidated_Expense_History_20250622.csv,2025-07-18T12:32:53.413399,3.0,advanced_calculations_v3,exp_v3_000390,2024.00,2.00,1.00,False,False,False,True,60
Ryan,2024-02-02,Capital One Savor One,In-N-Out Burger,,16.27,,Free for Jordyn,,,16.27,,0.00,simple,False,,expense_history_csv,Consolidated_Expense_History_20250622.csv,2025-07-18T12:32:53.413399,3.0,advanced_calculations_v3,exp_v3_000391,2024.00,2.00,1.00,False,False,False,True,40
Ryan,2024-02-02,Capital One Savor One,Whole Foods,,19.22,,Unknown - Free,,,19.22,,0.00,simple,False,,expense_history_csv,Consolidated_Expense_History_20250622.csv,2025-07-18T12:32:53.413399,3.0,advanced_calculations_v3,exp_v3_000392,2024.00,2.00,1.00,False,False,False,True,40
Ryan,2024-01-03,Capital One Savor One,Safeway,,90.09,90.09,Groceries,,,90.09,90.09,0.00,simple,False,,expense_history_csv,Consolidated_Expense_History_20250622.csv,2025-07-18T12:32:53.413399,3.0,advanced_calculations_v3,exp_v3_000393,2024.00,1.00,1.00,False,False,False,True,60
Ryan,2024-01-09,Capital One Savor One,Fry's,,142.59,142.59,Groceries,,,142.59,142.59,0.00,simple,False,,expense_history_csv,Consolidated_Expense_History_20250622.csv,2025-07-18T12:32:53.413399,3.0,advanced_calculations_v3,exp_v3_000394,2024.00,1.00,1.00,False,False,False,True,60
Ryan,2024-01-11,Capital One Savor One,Fry's,,47.31,47.31,Groceries,,,47.31,47.31,0.00,simple,False,,expense_history_csv,Consolidated_Expense_History_20250622.csv,2025-07-18T12:32:53.413399,3.0,advanced_calculations_v3,exp_v3_000395,2024.00,1.00,1.00,False,False,False,True,60
Ryan,2024-01-16,Capital One Walmart,Walmart,,41.18,41.18,Groceries,,,41.18,41.18,0.00,simple,False,,expense_history_csv,Consolidated_Expense_History_20250622.csv,2025-07-18T12:32:53.413399,3.0,advanced_calculations_v3,exp_v3_000396,2024.00,1.00,1.00,False,False,False,True,60
Ryan,2024-12-27,Credit One x 6396,Fry's,,9.64,9.64,Groceries,,,9.64,9.64,0.00,simple,False,,expense_history_csv,Consolidated_Expense_History_20250622.csv,2025-07-18T12:32:53.413399,3.0,advanced_calculations_v3,exp_v3_000397,2024.00,12.00,4.00,False,False,False,True,60
Ryan,2024-12-30,Credit One x 6396,Fry's,,26.67,26.67,Groceries,,,26.67,26.67,0.00,simple,False,,expense_history_csv,Consolidated_Expense_History_20250622.csv,2025-07-18T12:32:53.413399,3.0,advanced_calculations_v3,exp_v3_000398,2024.00,12.00,4.00,False,False,False,True,60
Ryan,2024-01-02,Credit One x 6396,Fry's,,1.63,1.63,Groceries,,,1.63,1.63,0.00,simple,False,,expense_history_csv,Consolidated_Expense_History_20250622.csv,2025-07-18T12:32:53.413399,3.0,advanced_calculations_v3,exp_v3_000399,2024.00,1.00,1.00,False,False,False,True,60
Ryan,2024-01-18,Credit One x 6396,Fry's,,44.72,44.72,Groceries,,,44.72,44.72,0.00,simple,False,,expense_history_csv,Consolidated_Expense_History_20250622.csv,2025-07-18T12:32:53.413399,3.0,advanced_calculations_v3,exp_v3_000400,2024.00,1.00,1.00,False,False,False,True,60
Ryan,2024-01-19,Credit One x 6396,Fry's,,24.43,24.43,Groceries,,,24.43,24.43,0.00,simple,False,,expense_history_csv,Consolidated_Expense_History_20250622.csv,2025-07-18T12:32:53.413399,3.0,advanced_calculations_v3,exp_v3_000401,2024.00,1.00,1.00,False,False,False,True,60
Ryan,2024-01-20,Credit One x 6396,Whole Foods,,15.09,15.09,,,,15.09,15.09,0.00,simple,False,,expense_history_csv,Consolidated_Expense_History_20250622.csv,2025-07-18T12:32:53.413399,3.0,advanced_calculations_v3,exp_v3_000402,2024.00,1.00,1.00,False,False,False,True,40
Ryan,2024-01-20,Credit One x 6396,Fry's,,27.97,27.97,,,,27.97,27.97,0.00,simple,False,,expense_history_csv,Consolidated_Expense_History_20250622.csv,2025-07-18T12:32:53.413399,3.0,advanced_calculations_v3,exp_v3_000403,2024.00,1.00,1.00,False,False,False,True,40
Ryan,2024-01-21,Credit One x 6396,Whole Foods,,29.10,29.10,,,,29.10,29.10,0.00,simple,False,,expense_history_csv,Consolidated_Expense_History_20250622.csv,2025-07-18T12:32:53.413399,3.0,advanced_calculations_v3,exp_v3_000404,2024.00,1.00,1.00,False,False,False,True,40
Ryan,2024-01-22,Credit One x 6396,Whole Foods,,28.01,28.01,,,,28.01,28.01,0.00,simple,False,,expense_history_csv,Consolidated_Expense_History_20250622.csv,2025-07-18T12:32:53.413399,3.0,advanced_calculations_v3,exp_v3_000405,2024.00,1.00,1.00,False,False,False,True,40
Ryan,2024-01-25,Credit One x 6396,Whole Foods,,14.00,14.00,,,,14.00,14.00,0.00,simple,False,,expense_history_csv,Consolidated_Expense_History_20250622.csv,2025-07-18T12:32:53.413399,3.0,advanced_calculations_v3,exp_v3_000406,2024.00,1.00,1.00,False,False,False,True,40
Ryan,2024-01-26,Credit One x 6396,Whole Foods,,28.01,28.01,,,,28.01,28.01,0.00,simple,False,,expense_history_csv,Consolidated_Expense_History_20250622.csv,2025-07-18T12:32:53.413399,3.0,advanced_calculations_v3,exp_v3_000407,2024.00,1.00,1.00,False,False,False,True,40
Ryan,2024-01-27,Credit One x 6396,Fry's,,27.61,27.61,,,,27.61,27.61,0.00,simple,False,,expense_history_csv,Consolidated_Expense_History_20250622.csv,2025-07-18T12:32:53.413399,3.0,advanced_calculations_v3,exp_v3_000408,2024.00,1.00,1.00,False,False,False,True,40
Ryan,2024-01-29,Credit One x 6396,Whole Foods,,29.10,,,,,29.10,,0.00,simple,False,,expense_history_csv,Consolidated_Expense_History_20250622.csv,2025-07-18T12:32:53.413399,3.0,advanced_calculations_v3,exp_v3_000409,2024.00,1.00,1.00,False,False,False,True,20
Ryan,2024-01-30,Credit One x 6396,Fry's,,53.50,,,,,53.50,,0.00,simple,False,,expense_history_csv,Consolidated_Expense_History_20250622.csv,2025-07-18T12:32:53.413399,3.0,advanced_calculations_v3,exp_v3_000410,2024.00,1.00,1.00,False,False,False,True,20
Ryan,2024-01-31,Credit One x 6396,Whole Foods,,29.10,,,,,29.10,,0.00,simple,False,,expense_history_csv,Consolidated_Expense_History_20250622.csv,2025-07-18T12:32:53.413399,3.0,advanced_calculations_v3,exp_v3_000411,2024.00,1.00,1.00,False,False,False,True,20
Ryan,2024-02-02,Credit One x 6396,Whole Foods,,23.37,23.37,,,,23.37,23.37,0.00,simple,False,,expense_history_csv,Consolidated_Expense_History_20250622.csv,2025-07-18T12:32:53.413399,3.0,advanced_calculations_v3,exp_v3_000412,2024.00,2.00,1.00,False,False,False,True,40
Ryan,2024-02-03,Credit One x 6396,Whole Foods,,30.49,30.49,,,,30.49,30.49,0.00,simple,False,,expense_history_csv,Consolidated_Expense_History_20250622.csv,2025-07-18T12:32:53.413399,3.0,advanced_calculations_v3,exp_v3_000413,2024.00,2.00,1.00,False,False,False,True,40
Ryan,2024-01-06,Wells Fargo Autograph,The Whining Pig Bar,,28.52,28.52,,,,28.52,28.52,0.00,simple,False,,expense_history_csv,Consolidated_Expense_History_20250622.csv,2025-07-18T12:32:53.413399,3.0,advanced_calculations_v3,exp_v3_000414,2024.00,1.00,1.00,False,False,False,True,40
Ryan,2024-01-08,Wells Fargo Autograph,Stadium Club,,14.51,14.51,,,,14.51,14.51,0.00,simple,False,,expense_history_csv,Consolidated_Expense_History_20250622.csv,2025-07-18T12:32:53.413399,3.0,advanced_calculations_v3,exp_v3_000415,2024.00,1.00,1.00,False,False,False,True,40
Ryan,2024-01-08,Wells Fargo Autograph,Thirsty Lion,,37.51,37.51,,,,37.51,37.51,0.00,simple,False,,expense_history_csv,Consolidated_Expense_History_20250622.csv,2025-07-18T12:32:53.413399,3.0,advanced_calculations_v3,exp_v3_000416,2024.00,1.00,1.00,False,False,False,True,40
Ryan,2024-01-08,Wells Fargo Autograph,Snooze,,42.58,42.58,,,,42.58,42.58,0.00,simple,False,,expense_history_csv,Consolidated_Expense_History_20250622.csv,2025-07-18T12:32:53.413399,3.0,advanced_calculations_v3,exp_v3_000417,2024.00,1.00,1.00,False,False,False,True,40
Ryan,2024-01-13,Wells Fargo Autograph,International Foods Cafe,,5.42,5.42,,,,5.42,5.42,0.00,simple,False,,expense_history_csv,Consolidated_Expense_History_20250622.csv,2025-07-18T12:32:53.413399,3.0,advanced_calculations_v3,exp_v3_000418,2024.00,1.00,1.00,False,False,False,True,40
Ryan,2024-01-13,Wells Fargo Autograph,Whole Foods,,74.44,74.44,,,,74.44,74.44,0.00,simple,False,,expense_history_csv,Consolidated_Expense_History_20250622.csv,2025-07-18T12:32:53.413399,3.0,advanced_calculations_v3,exp_v3_000419,2024.00,1.00,1.00,False,False,False,True,40
Ryan,2024-01-16,Wells Fargo Autograph,Jewel's Bakery & Cafe,,72.82,,,,,72.82,,0.00,simple,False,,expense_history_csv,Consolidated_Expense_History_20250622.csv,2025-07-18T12:32:53.413399,3.0,advanced_calculations_v3,exp_v3_000420,2024.00,1.00,1.00,False,False,False,True,20
Ryan,2024-01-20,Wells Fargo Autograph,Carquest,,24.83,,???,,,24.83,,3.00,complex,True,Manual review required: ???,expense_history_csv,Consolidated_Expense_History_20250622.csv,2025-07-18T12:32:53.413399,3.0,advanced_calculations_v3,exp_v3_000421,2024.00,1.00,1.00,True,False,False,True,20
Ryan,2024-01-20,Wells Fargo Autograph,Robert's Ace Hardware,,9.26,9.26,,,,9.26,9.26,0.00,simple,False,,expense_history_csv,Consolidated_Expense_History_20250622.csv,2025-07-18T12:32:53.413399,3.0,advanced_calculations_v3,exp_v3_000422,2024.00,1.00,1.00,False,False,False,True,40
Ryan,2024-01-26,Wells Fargo Autograph,Kodo Sushi,,72.37,72.37,,,,72.37,72.37,0.00,simple,False,,expense_history_csv,Consolidated_Expense_History_20250622.csv,2025-07-18T12:32:53.413399,3.0,advanced_calculations_v3,exp_v3_000423,2024.00,1.00,1.00,False,False,False,True,40
Ryan,2024-01-26,Wells Fargo Autograph,Netflix,,24.78,24.78,Look into dropping to the cheaper plan,,,24.78,24.78,0.00,simple,False,,expense_history_csv,Consolidated_Expense_History_20250622.csv,2025-07-18T12:32:53.413399,3.0,advanced_calculations_v3,exp_v3_000424,2024.00,1.00,1.00,False,False,False,True,60
Ryan,2024-02-02,Wells Fargo Autograph,Cooper's Hawk,,59.57,59.57,,,,59.57,59.57,0.00,simple,False,,expense_history_csv,Consolidated_Expense_History_20250622.csv,2025-07-18T12:32:53.413399,3.0,advanced_calculations_v3,exp_v3_000425,2024.00,2.00,1.00,False,False,False,True,40
Ryan,2024-02-03,Wells Fargo Autograph,Taste of China,,50.72,50.72,,,,50.72,50.72,0.00,simple,False,,expense_history_csv,Consolidated_Expense_History_20250622.csv,2025-07-18T12:32:53.413399,3.0,advanced_calculations_v3,exp_v3_000426,2024.00,2.00,1.00,False,False,False,True,40
Ryan,2024-02-04,Wells Fargo Autograph,Snooze,,33.84,33.84,,,,33.84,33.84,0.00,simple,False,,expense_history_csv,Consolidated_Expense_History_20250622.csv,2025-07-18T12:32:53.413399,3.0,advanced_calculations_v3,exp_v3_000427,2024.00,2.00,1.00,False,False,False,True,40
Ryan,2024-01-13,Target Redcard,Target,,16.39,16.39,,,,16.39,16.39,0.00,simple,False,,expense_history_csv,Consolidated_Expense_History_20250622.csv,2025-07-18T12:32:53.413399,3.0,advanced_calculations_v3,exp_v3_000428,2024.00,1.00,1.00,False,False,False,True,40
Ryan,2024-01-15,Target Redcard,Target,,5.30,5.30,,,,5.30,5.30,0.00,simple,False,,expense_history_csv,Consolidated_Expense_History_20250622.csv,2025-07-18T12:32:53.413399,3.0,advanced_calculations_v3,exp_v3_000429,2024.00,1.00,1.00,False,False,False,True,40
Ryan,2024-12-22,Best Buy Citi,Best Buy,,146.00,,TV,,,146.00,,0.00,simple,False,,expense_history_csv,Consolidated_Expense_History_20250622.csv,2025-07-18T12:32:53.413399,3.0,advanced_calculations_v3,exp_v3_000430,2024.00,12.00,4.00,False,False,False,True,40
Ryan,2024-01-22,Best Buy Citi,Best Buy,,146.00,,TV,,,146.00,,0.00,simple,False,,expense_history_csv,Consolidated_Expense_History_20250622.csv,2025-07-18T12:32:53.413399,3.0,advanced_calculations_v3,exp_v3_000431,2024.00,1.00,1.00,False,False,False,True,40
Ryan,2024-02-03,Best Buy Citi,Best Buy,,500.00,146.00,TV - $500 Less $146 Autopay,,,500.00,146.00,0.00,simple,False,,expense_history_csv,Consolidated_Expense_History_20250622.csv,2025-07-18T12:32:53.413399,3.0,advanced_calculations_v3,exp_v3_000432,2024.00,2.00,1.00,False,False,False,True,60
Ryan,2024-01-04,Kohl's,Kohl's,,343.94,50.00,"Patio Chairs, Kitchen Towels, Heated Blanket, Super Rest Down Comforter (343.94 - 240.59) Kohl's cash?? Ryan response: Partially, but I worked for this Kohl's' cash. We will need to discuss further, as that Kohl's cash I earned with hours of time invested.",,,343.94,50.00,5.00,complex,True,Mathematical operation: 343.94 - 240.59; Mathematical operation: (343.94 - 240.59); Manual review required: Discuss further,expense_history_csv,Consolidated_Expense_History_20250622.csv,2025-07-18T12:32:53.413399,3.0,advanced_calculations_v3,exp_v3_000433,2024.00,1.00,1.00,True,False,False,True,40
Ryan,2024-01-15,Kohl's,Kohl's,,100.69,100.69,"Spice Rack, Back Stretching Device, 4 Pillows (100.69-32.98) ***Remove $29.99 for Back Stretching Device***",,,100.69,100.69,8.00,exclusion_adjustment,False,Mathematical operation: 100.69-32.98; Mathematical operation: (100.69-32.98); Exclusion adjustment: Remove $29.99 for Back Stretching Device***; Exclusion adjustment: Remove $29.99 for Back Stretching Device***; Exclusion adjustment: ***Remove $29.99 for Back Stretching Device***,expense_history_csv,Consolidated_Expense_History_20250622.csv,2025-07-18T12:32:53.413399,3.0,advanced_calculations_v3,exp_v3_000434,2024.00,1.00,1.00,True,True,False,True,60
Ryan,2024-01-26,Bed Bath & Beyond,Bed Bath & Beyond,,251.99,,Glass Top Computer Desk (251.99-50.40-200.00) - Discuss further.,,,251.99,,5.00,complex,True,Mathematical operation: 251.99-50.40; Mathematical operation: (251.99-50.40-200.00); Manual review required: Discuss further,expense_history_csv,Consolidated_Expense_History_20250622.csv,2025-07-18T12:32:53.413399,3.0,advanced_calculations_v3,exp_v3_000435,2024.00,1.00,1.00,True,False,False,True,20
Ryan,2024-01-02,EBT,Fry's,,37.04,37.04,Groceries,,,37.04,37.04,0.00,simple,False,,expense_history_csv,Consolidated_Expense_History_20250622.csv,2025-07-18T12:32:53.413399,3.0,advanced_calculations_v3,exp_v3_000436,2024.00,1.00,1.00,False,False,False,True,60
Ryan,2024-01-09,EBT,Fry's,,91.03,91.03,Groceries,,,91.03,91.03,0.00,simple,False,,expense_history_csv,Consolidated_Expense_History_20250622.csv,2025-07-18T12:32:53.413399,3.0,advanced_calculations_v3,exp_v3_000437,2024.00,1.00,1.00,False,False,False,True,60
Ryan,2024-01-15,EBT,Fry's,,164.74,164.74,Groceries,,,164.74,164.74,0.00,simple,False,,expense_history_csv,Consolidated_Expense_History_20250622.csv,2025-07-18T12:32:53.413399,3.0,advanced_calculations_v3,exp_v3_000438,2024.00,1.00,1.00,False,False,False,True,60
Ryan,2024-12-19,Wells Fargo Checking,SRP,,166.50,166.50,Electric - Missed,,,166.50,166.50,0.00,simple,False,,expense_history_csv,Consolidated_Expense_History_20250622.csv,2025-07-18T12:32:53.413399,3.0,advanced_calculations_v3,exp_v3_000439,2024.00,12.00,4.00,False,False,False,True,60
Ryan,2024-01-05,Wells Fargo Checking,Cox,,89.99,89.99,Internet,,,89.99,89.99,0.00,simple,False,,expense_history_csv,Consolidated_Expense_History_20250622.csv,2025-07-18T12:32:53.413399,3.0,advanced_calculations_v3,exp_v3_000440,2024.00,1.00,1.00,False,False,False,True,60
Ryan,2024-02-05,Wells Fargo Checking,Cox,,90.00,90.00,Internet,,,90.00,90.00,0.00,simple,False,,expense_history_csv,Consolidated_Expense_History_20250622.csv,2025-07-18T12:32:53.413399,3.0,advanced_calculations_v3,exp_v3_000441,2024.00,2.00,1.00,False,False,False,True,60
Ryan,2024-01-18,Wells Fargo Checking,SRP,,74.32,74.32,Electric,,,74.32,74.32,0.00,simple,False,,expense_history_csv,Consolidated_Expense_History_20250622.csv,2025-07-18T12:32:53.413399,3.0,advanced_calculations_v3,exp_v3_000442,2024.00,1.00,1.00,False,False,False,True,60
Ryan,2024-01-04,Affirm,Amazon,,149.95,149.95,"SoundAsleep Air Mattress --- what happened to the one returned??? Ryan response: this is the original, the return was $0.00. Note the date of purchase is 01/04/2024. Order #111-2504086-5973049",,,149.95,149.95,5.00,complex,True,Mathematical operation: 111-2504086; Mathematical operation: 01/04; Manual review required: ???,expense_history_csv,Consolidated_Expense_History_20250622.csv,2025-07-18T12:32:53.413399,3.0,advanced_calculations_v3,exp_v3_000443,2024.00,1.00,1.00,True,False,False,True,40
Ryan,2024-01-26,Target,Target,,105.61,105.61,3x3 Cube Organizer,,,105.61,105.61,0.00,simple,False,,expense_history_csv,Consolidated_Expense_History_20250622.csv,2025-07-18T12:32:53.413399,3.0,advanced_calculations_v3,exp_v3_000444,2024.00,1.00,1.00,False,False,False,True,60
Ryan,2024-01-03,Cash,Rebecca,,220.00,220.00,,,,220.00,220.00,0.00,simple,False,,expense_history_csv,Consolidated_Expense_History_20250622.csv,2025-07-18T12:32:53.413399,3.0,advanced_calculations_v3,exp_v3_000445,2024.00,1.00,1.00,False,False,False,True,40
Ryan,2024-01-07,Cash,Rebecca,,220.00,220.00,,,,220.00,220.00,0.00,simple,False,,expense_history_csv,Consolidated_Expense_History_20250622.csv,2025-07-18T12:32:53.413399,3.0,advanced_calculations_v3,exp_v3_000446,2024.00,1.00,1.00,False,False,False,True,40
Ryan,2024-01-11,Cash,Rebecca,,220.00,220.00,,,,220.00,220.00,0.00,simple,False,,expense_history_csv,Consolidated_Expense_History_20250622.csv,2025-07-18T12:32:53.413399,3.0,advanced_calculations_v3,exp_v3_000447,2024.00,1.00,1.00,False,False,False,True,40
Ryan,2024-01-26,Cash,1853,,220.00,220.00,,,,220.00,220.00,0.00,simple,False,,expense_history_csv,Consolidated_Expense_History_20250622.csv,2025-07-18T12:32:53.413399,3.0,advanced_calculations_v3,exp_v3_000448,2024.00,1.00,1.00,False,False,False,True,40
Ryan,2024-02-03,Cash,Rebecca,,220.00,220.00,,,,220.00,220.00,0.00,simple,False,,expense_history_csv,Consolidated_Expense_History_20250622.csv,2025-07-18T12:32:53.413399,3.0,advanced_calculations_v3,exp_v3_000449,2024.00,2.00,1.00,False,False,False,True,40
Ryan,2024-11-27,Cash,Rebecca,,220.00,220.00,Missed,,,220.00,220.00,0.00,simple,False,,expense_history_csv,Consolidated_Expense_History_20250622.csv,2025-07-18T12:32:53.413399,3.0,advanced_calculations_v3,exp_v3_000450,2024.00,11.00,4.00,False,False,False,True,60
Ryan,2024-01-14,Wallet,Bro,,235.00,235.00,,,,235.00,235.00,0.00,simple,False,,expense_history_csv,Consolidated_Expense_History_20250622.csv,2025-07-18T12:32:53.413399,3.0,advanced_calculations_v3,exp_v3_000451,2024.00,1.00,1.00,False,False,False,True,40
Ryan,2024-01-22,Wallet,Bro,,230.00,,,,,230.00,,0.00,simple,False,,expense_history_csv,Consolidated_Expense_History_20250622.csv,2025-07-18T12:32:53.413399,3.0,advanced_calculations_v3,exp_v3_000452,2024.00,1.00,1.00,False,False,False,True,20
Ryan,2024-01-27,Wallet,Bro,,225.00,,,,,225.00,,0.00,simple,False,,expense_history_csv,Consolidated_Expense_History_20250622.csv,2025-07-18T12:32:53.413399,3.0,advanced_calculations_v3,exp_v3_000453,2024.00,1.00,1.00,False,False,False,True,20
Ryan,2024-02-03,Wallet,Bro,,225.00,225.00,,,,225.00,225.00,0.00,simple,False,,expense_history_csv,Consolidated_Expense_History_20250622.csv,2025-07-18T12:32:53.413399,3.0,advanced_calculations_v3,exp_v3_000454,2024.00,2.00,1.00,False,False,False,True,40
Ryan,2024-01-15,Amazon Gift Card/ 4893/ 0651,Amazon,,85.58,,CoQ10 200 x2 (Jordyn & Ryan),,,85.58,,1.00,simple,False,Mathematical operation: (Jordyn & Ryan),expense_history_csv,Consolidated_Expense_History_20250622.csv,2025-07-18T12:32:53.413399,3.0,advanced_calculations_v3,exp_v3_000455,2024.00,1.00,1.00,False,False,False,True,40
Ryan,2024-01-20,Mastercard x9585,Amazon,,61.72,,"Drawer Organizer, investigate. (61.72-39.56 Refund) Order# 113-3380358-9555412",,,61.72,,3.00,complex,False,Mathematical operation: 61.72-39.56; Mathematical operation: 113-3380358; Mathematical operation: (61.72-39.56 Refund),expense_history_csv,Consolidated_Expense_History_20250622.csv,2025-07-18T12:32:53.413399,3.0,advanced_calculations_v3,exp_v3_000456,2024.00,1.00,1.00,True,False,False,True,40
Ryan,2024-01-20,Ally,Amazon,,19.99,19.99,25' Ethernet Cable,,,19.99,19.99,0.00,simple,False,,expense_history_csv,Consolidated_Expense_History_20250622.csv,2025-07-18T12:32:53.413399,3.0,advanced_calculations_v3,exp_v3_000457,2024.00,1.00,1.00,False,False,False,True,60
Ryan,,Klarna,Bed Bath & Beyond,,193.68,193.68,12/12/2023 - Missed due to Klarna (Lateral File Cabinet & Baking Sheets),,,193.68,193.68,2.00,simple,False,Mathematical operation: 12/12; Mathematical operation: (Lateral File Cabinet & Baking Sheets),expense_history_csv,Consolidated_Expense_History_20250622.csv,2025-07-18T12:32:53.413399,3.0,advanced_calculations_v3,exp_v3_000458,,,,False,False,False,False,20
Ryan,,,,,,,,,,,,0.00,simple,False,,expense_history_csv,Consolidated_Expense_History_20250622.csv,2025-07-18T12:32:53.413399,3.0,advanced_calculations_v3,exp_v3_000459,,,,False,False,False,False,-20
Jordyn,,,,,,,,,,,,0.00,simple,False,,expense_history_csv,Consolidated_Expense_History_20250622.csv,2025-07-18T12:32:53.413399,3.0,advanced_calculations_v3,exp_v3_000460,,,,False,False,False,False,-20
Jordyn,2024-01-21,Chase,Kindle Unlimited,,12.96,12.96,,,,12.96,12.96,0.00,simple,False,,expense_history_csv,Consolidated_Expense_History_20250622.csv,2025-07-18T12:32:53.413399,3.0,advanced_calculations_v3,exp_v3_000461,2024.00,1.00,1.00,False,False,False,True,40
Jordyn,2024-12-18,Chase,Bobs,,72.95,72.95,,,,72.95,72.95,0.00,simple,False,,expense_history_csv,Consolidated_Expense_History_20250622.csv,2025-07-18T12:32:53.413399,3.0,advanced_calculations_v3,exp_v3_000462,2024.00,12.00,4.00,False,False,False,True,40
Jordyn,2024-01-21,Chase,Bobs,,72.95,72.95,,,,72.95,72.95,0.00,simple,False,,expense_history_csv,Consolidated_Expense_History_20250622.csv,2025-07-18T12:32:53.413399,3.0,advanced_calculations_v3,exp_v3_000463,2024.00,1.00,1.00,False,False,False,True,40
Jordyn,2024-01-03,Chase,Sprouts,,54.12,54.12,,,,54.12,54.12,0.00,simple,False,,expense_history_csv,Consolidated_Expense_History_20250622.csv,2025-07-18T12:32:53.413399,3.0,advanced_calculations_v3,exp_v3_000464,2024.00,1.00,1.00,False,False,False,True,40
Jordyn,2024-01-05,Chase,Frys,,25.38,25.38,,,,25.38,25.38,0.00,simple,False,,expense_history_csv,Consolidated_Expense_History_20250622.csv,2025-07-18T12:32:53.413399,3.0,advanced_calculations_v3,exp_v3_000465,2024.00,1.00,1.00,False,False,False,True,40
Jordyn,2024-01-05,Chase,Home Depot,,13.43,13.43,,,,13.43,13.43,0.00,simple,False,,expense_history_csv,Consolidated_Expense_History_20250622.csv,2025-07-18T12:32:53.413399,3.0,advanced_calculations_v3,exp_v3_000466,2024.00,1.00,1.00,False,False,False,True,40
Jordyn,2024-01-06,Chase,Bashas,,90.23,90.23,,,,90.23,90.23,0.00,simple,False,,expense_history_csv,Consolidated_Expense_History_20250622.csv,2025-07-18T12:32:53.413399,3.0,advanced_calculations_v3,exp_v3_000467,2024.00,1.00,1.00,False,False,False,True,40
Jordyn,2024-01-06,Chase,Snooze,,42.58,42.58,,,,42.58,42.58,0.00,simple,False,,expense_history_csv,Consolidated_Expense_History_20250622.csv,2025-07-18T12:32:53.413399,3.0,advanced_calculations_v3,exp_v3_000468,2024.00,1.00,1.00,False,False,False,True,40
Jordyn,2024-01-07,Chase,Chipotle,,28.43,28.43,,,,28.43,28.43,0.00,simple,False,,expense_history_csv,Consolidated_Expense_History_20250622.csv,2025-07-18T12:32:53.413399,3.0,advanced_calculations_v3,exp_v3_000469,2024.00,1.00,1.00,False,False,False,True,40
Jordyn,2024-01-07,Chase,Amazon,,14.54,14.54,,,,14.54,14.54,0.00,simple,False,,expense_history_csv,Consolidated_Expense_History_20250622.csv,2025-07-18T12:32:53.413399,3.0,advanced_calculations_v3,exp_v3_000470,2024.00,1.00,1.00,False,False,False,True,40
Jordyn,2024-01-08,Chase,Thirsty Lion,,37.52,37.52,,,,37.52,37.52,0.00,simple,False,,expense_history_csv,Consolidated_Expense_History_20250622.csv,2025-07-18T12:32:53.413399,3.0,advanced_calculations_v3,exp_v3_000471,2024.00,1.00,1.00,False,False,False,True,40
Jordyn,2024-01-09,Chase,Frys,,92.05,92.05,,,,92.05,92.05,0.00,simple,False,,expense_history_csv,Consolidated_Expense_History_20250622.csv,2025-07-18T12:32:53.413399,3.0,advanced_calculations_v3,exp_v3_000472,2024.00,1.00,1.00,False,False,False,True,40
Jordyn,2024-01-10,Chase,Target,,8.51,8.51,,,,8.51,8.51,0.00,simple,False,,expense_history_csv,Consolidated_Expense_History_20250622.csv,2025-07-18T12:32:53.413399,3.0,advanced_calculations_v3,exp_v3_000473,2024.00,1.00,1.00,False,False,False,True,40
Jordyn,2024-01-13,Chase,Intentional Foods,,49.28,49.28,,,,49.28,49.28,0.00,simple,False,,expense_history_csv,Consolidated_Expense_History_20250622.csv,2025-07-18T12:32:53.413399,3.0,advanced_calculations_v3,exp_v3_000474,2024.00,1.00,1.00,False,False,False,True,40
Jordyn,2024-01-14,Chase,Amazon,,29.92,29.92,,,,29.92,29.92,0.00,simple,False,,expense_history_csv,Consolidated_Expense_History_20250622.csv,2025-07-18T12:32:53.413399,3.0,advanced_calculations_v3,exp_v3_000475,2024.00,1.00,1.00,False,False,False,True,40
Jordyn,2024-01-14,Chase,Amazon,,36.86,36.86,,,,36.86,36.86,0.00,simple,False,,expense_history_csv,Consolidated_Expense_History_20250622.csv,2025-07-18T12:32:53.413399,3.0,advanced_calculations_v3,exp_v3_000476,2024.00,1.00,1.00,False,False,False,True,40
Jordyn,2024-01-16,Chase,Whole Foods,,11.26,11.26,,,,11.26,11.26,0.00,simple,False,,expense_history_csv,Consolidated_Expense_History_20250622.csv,2025-07-18T12:32:53.413399,3.0,advanced_calculations_v3,exp_v3_000477,2024.00,1.00,1.00,False,False,False,True,40
Jordyn,2024-01-16,Chase,Frys,,11.86,11.86,,,,11.86,11.86,0.00,simple,False,,expense_history_csv,Consolidated_Expense_History_20250622.csv,2025-07-18T12:32:53.413399,3.0,advanced_calculations_v3,exp_v3_000478,2024.00,1.00,1.00,False,False,False,True,40
Jordyn,2024-01-16,Chase,Frys,,7.09,7.09,,,,7.09,7.09,0.00,simple,False,,expense_history_csv,Consolidated_Expense_History_20250622.csv,2025-07-18T12:32:53.413399,3.0,advanced_calculations_v3,exp_v3_000479,2024.00,1.00,1.00,False,False,False,True,40
Jordyn,2024-01-19,Chase,Sprouts,,35.26,35.26,,,,35.26,35.26,0.00,simple,False,,expense_history_csv,Consolidated_Expense_History_20250622.csv,2025-07-18T12:32:53.413399,3.0,advanced_calculations_v3,exp_v3_000480,2024.00,1.00,1.00,False,False,False,True,40
Jordyn,2024-01-23,Chase,Frys,,58.60,58.60,,,,58.60,58.60,0.00,simple,False,,expense_history_csv,Consolidated_Expense_History_20250622.csv,2025-07-18T12:32:53.413399,3.0,advanced_calculations_v3,exp_v3_000481,2024.00,1.00,1.00,False,False,False,True,40
Jordyn,2024-01-23,Chase,Frys,,270.30,270.30,,,,270.30,270.30,0.00,simple,False,,expense_history_csv,Consolidated_Expense_History_20250622.csv,2025-07-18T12:32:53.413399,3.0,advanced_calculations_v3,exp_v3_000482,2024.00,1.00,1.00,False,False,False,True,40
Jordyn,2024-01-23,Chase,Flower Child,,34.41,34.41,,,,34.41,34.41,0.00,simple,False,,expense_history_csv,Consolidated_Expense_History_20250622.csv,2025-07-18T12:32:53.413399,3.0,advanced_calculations_v3,exp_v3_000483,2024.00,1.00,1.00,False,False,False,True,40
Jordyn,2024-01-24,Chase,Amazon,,67.86,67.86,,,,67.86,67.86,0.00,simple,False,,expense_history_csv,Consolidated_Expense_History_20250622.csv,2025-07-18T12:32:53.413399,3.0,advanced_calculations_v3,exp_v3_000484,2024.00,1.00,1.00,False,False,False,True,40
Jordyn,2024-01-26,Chase,Sprouts,,18.86,18.86,,,,18.86,18.86,0.00,simple,False,,expense_history_csv,Consolidated_Expense_History_20250622.csv,2025-07-18T12:32:53.413399,3.0,advanced_calculations_v3,exp_v3_000485,2024.00,1.00,1.00,False,False,False,True,40
Jordyn,2024-01-27,Chase,The Forum (bar),,52.95,52.95,,,,52.95,52.95,0.00,simple,False,,expense_history_csv,Consolidated_Expense_History_20250622.csv,2025-07-18T12:32:53.413399,3.0,advanced_calculations_v3,exp_v3_000486,2024.00,1.00,1.00,False,False,False,True,40
Jordyn,2024-01-28,Chase,Whole Foods,,18.34,18.34,,,,18.34,18.34,0.00,simple,False,,expense_history_csv,Consolidated_Expense_History_20250622.csv,2025-07-18T12:32:53.413399,3.0,advanced_calculations_v3,exp_v3_000487,2024.00,1.00,1.00,False,False,False,True,40
Jordyn,2024-02-01,Chase,Frys,,25.38,25.38,,,,25.38,25.38,0.00,simple,False,,expense_history_csv,Consolidated_Expense_History_20250622.csv,2025-07-18T12:32:53.413399,3.0,advanced_calculations_v3,exp_v3_000488,2024.00,2.00,1.00,False,False,False,True,40
Jordyn,2024-02-02,Chase,Cooper's Hawk,,59.97,59.97,,,,59.97,59.97,0.00,simple,False,,expense_history_csv,Consolidated_Expense_History_20250622.csv,2025-07-18T12:32:53.413399,3.0,advanced_calculations_v3,exp_v3_000489,2024.00,2.00,1.00,False,False,False,True,40
Jordyn,2024-02-03,Chase,Whole Foods,,41.07,41.07,,,,41.07,41.07,0.00,simple,False,,expense_history_csv,Consolidated_Expense_History_20250622.csv,2025-07-18T12:32:53.413399,3.0,advanced_calculations_v3,exp_v3_000490,2024.00,2.00,1.00,False,False,False,True,40
Jordyn,2024-02-03,Chase,Snooze,,33.83,33.83,,,,33.83,33.83,0.00,simple,False,,expense_history_csv,Consolidated_Expense_History_20250622.csv,2025-07-18T12:32:53.413399,3.0,advanced_calculations_v3,exp_v3_000491,2024.00,2.00,1.00,False,False,False,True,40
Jordyn,2024-02-05,Chase,Whole Foods,,25.74,25.74,,,,25.74,25.74,0.00,simple,False,,expense_history_csv,Consolidated_Expense_History_20250622.csv,2025-07-18T12:32:53.413399,3.0,advanced_calculations_v3,exp_v3_000492,2024.00,2.00,1.00,False,False,False,True,40
Jordyn,2024-02-05,Chase,Frys,,110.32,110.32,,,,110.32,110.32,0.00,simple,False,,expense_history_csv,Consolidated_Expense_History_20250622.csv,2025-07-18T12:32:53.413399,3.0,advanced_calculations_v3,exp_v3_000493,2024.00,2.00,1.00,False,False,False,True,40
Ryan,2024-02-09,Mercury,Amazon,,34.81,,Refund - back pillow,,,34.81,,0.00,simple,False,,expense_history_csv,Consolidated_Expense_History_20250622.csv,2025-07-18T12:32:53.413399,3.0,advanced_calculations_v3,exp_v3_000494,2024.00,2.00,1.00,False,False,False,True,40
Ryan,2024-02-10,Mercury,Oculus,,10.77,,Surgineer,,,10.77,,0.00,simple,False,,expense_history_csv,Consolidated_Expense_History_20250622.csv,2025-07-18T12:32:53.413399,3.0,advanced_calculations_v3,exp_v3_000495,2024.00,2.00,1.00,False,False,False,True,40
Ryan,2024-02-10,Mercury,Oculus,,21.55,21.55,Loco Dojo Unleashed,,,21.55,21.55,0.00,simple,False,,expense_history_csv,Consolidated_Expense_History_20250622.csv,2025-07-18T12:32:53.413399,3.0,advanced_calculations_v3,exp_v3_000496,2024.00,2.00,1.00,False,False,False,True,60
Ryan,2024-02-10,Mercury,Oculus,,16.16,,Pinball FX2 VR,,,16.16,,0.00,simple,False,,expense_history_csv,Consolidated_Expense_History_20250622.csv,2025-07-18T12:32:53.413399,3.0,advanced_calculations_v3,exp_v3_000497,2024.00,2.00,1.00,False,False,False,True,40
Ryan,2024-02-10,Mercury,Oculus,,21.55,,ForeVR Bowl,,,21.55,,0.00,simple,False,,expense_history_csv,Consolidated_Expense_History_20250622.csv,2025-07-18T12:32:53.413399,3.0,advanced_calculations_v3,exp_v3_000498,2024.00,2.00,1.00,False,False,False,True,40
Ryan,2024-02-15,Mercury,Amazon,,6.90,,Word Search Puzzles,,,6.90,,0.00,simple,False,,expense_history_csv,Consolidated_Expense_History_20250622.csv,2025-07-18T12:32:53.413399,3.0,advanced_calculations_v3,exp_v3_000499,2024.00,2.00,1.00,False,False,False,True,40
Ryan,2024-02-15,Mercury,Amazon,,3.82,,Word Search Puzzles,,,3.82,,0.00,simple,False,,expense_history_csv,Consolidated_Expense_History_20250622.csv,2025-07-18T12:32:53.413399,3.0,advanced_calculations_v3,exp_v3_000500,2024.00,2.00,1.00,False,False,False,True,40
Ryan,2024-02-18,Mercury,Playstation Network,,53.89,,Wurzer Paid Video Game - Prince of Persia,,,53.89,,0.00,simple,False,,expense_history_csv,Consolidated_Expense_History_20250622.csv,2025-07-18T12:32:53.413399,3.0,advanced_calculations_v3,exp_v3_000501,2024.00,2.00,1.00,False,False,False,True,40
Ryan,2024-02-24,Mercury,Keto Kitchen,,18.30,18.30,Dinner / Fun,,,18.30,18.30,0.00,simple,False,,expense_history_csv,Consolidated_Expense_History_20250622.csv,2025-07-18T12:32:53.413399,3.0,advanced_calculations_v3,exp_v3_000502,2024.00,2.00,1.00,False,False,False,True,60
Ryan,2024-02-24,Mercury,Native Winds,,48.51,,Dinner / Fun- earrings,,,48.51,,0.00,simple,False,,expense_history_csv,Consolidated_Expense_History_20250622.csv,2025-07-18T12:32:53.413399,3.0,advanced_calculations_v3,exp_v3_000503,2024.00,2.00,1.00,False,False,False,True,40
Ryan,2024-02-24,Mercury,Black Orchards,,13.39,13.39,Dinner / Fun,,,13.39,13.39,0.00,simple,False,,expense_history_csv,Consolidated_Expense_History_20250622.csv,2025-07-18T12:32:53.413399,3.0,advanced_calculations_v3,exp_v3_000504,2024.00,2.00,1.00,False,False,False,True,60
Ryan,2024-02-24,Mercury,Sprouts,,17.00,17.00,Steaks,,,17.00,17.00,0.00,simple,False,,expense_history_csv,Consolidated_Expense_History_20250622.csv,2025-07-18T12:32:53.413399,3.0,advanced_calculations_v3,exp_v3_000505,2024.00,2.00,1.00,False,False,False,True,60
Ryan,2024-02-24,Mercury,The Sleepy Whale,,48.24,48.24,Dinner / Fun,,,48.24,48.24,0.00,simple,False,,expense_history_csv,Consolidated_Expense_History_20250622.csv,2025-07-18T12:32:53.413399,3.0,advanced_calculations_v3,exp_v3_000506,2024.00,2.00,1.00,False,False,False,True,60
Ryan,2024-02-25,Mercury,Kindle Unlimited,,12.93,12.93,We must be on my Kindle Unlimited plan or Amazon is screwing with me lol - occurrence #6,,,12.93,12.93,0.00,simple,False,,expense_history_csv,Consolidated_Expense_History_20250622.csv,2025-07-18T12:32:53.413399,3.0,advanced_calculations_v3,exp_v3_000507,2024.00,2.00,1.00,False,False,False,True,60
Ryan,2024-02-25,Mercury,Fry's,,37.31,37.31,"Rotisserie Chicken, HIgh Noon, Cutwater Mango Tequila",,,37.31,37.31,0.00,simple,False,,expense_history_csv,Consolidated_Expense_History_20250622.csv,2025-07-18T12:32:53.413399,3.0,advanced_calculations_v3,exp_v3_000508,2024.00,2.00,1.00,False,False,False,True,60
Ryan,2024-02-26,Mercury,Oculus,,10.77,,Hand Physics Lab,,,10.77,,0.00,simple,False,,expense_history_csv,Consolidated_Expense_History_20250622.csv,2025-07-18T12:32:53.413399,3.0,advanced_calculations_v3,exp_v3_000509,2024.00,2.00,1.00,False,False,False,True,40
Ryan,2024-02-27,Mercury,Amazon,,20.82,,"Compression socks, arm sleeves, and GPU Brace",,,20.82,,0.00,simple,False,,expense_history_csv,Consolidated_Expense_History_20250622.csv,2025-07-18T12:32:53.413399,3.0,advanced_calculations_v3,exp_v3_000510,2024.00,2.00,1.00,False,False,False,True,40
Ryan,2024-02-27,Mercury,Amazon,,25.86,,Compression arm sleeves,,,25.86,,0.00,simple,False,,expense_history_csv,Consolidated_Expense_History_20250622.csv,2025-07-18T12:32:53.413399,3.0,advanced_calculations_v3,exp_v3_000511,2024.00,2.00,1.00,False,False,False,True,40
Ryan,2024-02-29,Mercury,Amazon,,34.46,34.46,Meat Thermometers- being returned,,,34.46,34.46,0.00,simple,False,,expense_history_csv,Consolidated_Expense_History_20250622.csv,2025-07-18T12:32:53.413399,3.0,advanced_calculations_v3,exp_v3_000512,2024.00,2.00,1.00,False,False,False,True,60
Ryan,2024-03-02,Mercury,Amazon,,37.70,,SI-LOC & Weight LIfting Belt,,,37.70,,0.00,simple,False,,expense_history_csv,Consolidated_Expense_History_20250622.csv,2025-07-18T12:32:53.413399,3.0,advanced_calculations_v3,exp_v3_000513,2024.00,3.00,1.00,False,False,False,True,40
Ryan,2024-03-03,Mercury,Playstation Network,,12.92,,Dirt 5,,,12.92,,0.00,simple,False,,expense_history_csv,Consolidated_Expense_History_20250622.csv,2025-07-18T12:32:53.413399,3.0,advanced_calculations_v3,exp_v3_000514,2024.00,3.00,1.00,False,False,False,True,40
Ryan,2024-03-03,Mercury,Playstation Network,,64.67,,UFC 5 Deluxe Edition,,,64.67,,0.00,simple,False,,expense_history_csv,Consolidated_Expense_History_20250622.csv,2025-07-18T12:32:53.413399,3.0,advanced_calculations_v3,exp_v3_000515,2024.00,3.00,1.00,False,False,False,True,40
Ryan,2024-03-03,Mercury,Playstation Network,,21.55,,Resident Evil Village Gold Edition,,,21.55,,0.00,simple,False,,expense_history_csv,Consolidated_Expense_History_20250622.csv,2025-07-18T12:32:53.413399,3.0,advanced_calculations_v3,exp_v3_000516,2024.00,3.00,1.00,False,False,False,True,40
Ryan,2024-03-03,Mercury,Playstation Network,,18.85,,Yoga Master,,,18.85,,0.00,simple,False,,expense_history_csv,Consolidated_Expense_History_20250622.csv,2025-07-18T12:32:53.413399,3.0,advanced_calculations_v3,exp_v3_000517,2024.00,3.00,1.00,False,False,False,True,40
Ryan,2024-03-06,Mercury,Amazon,,7.49,,SoulGenie TipGuard,,,7.49,,0.00,simple,False,,expense_history_csv,Consolidated_Expense_History_20250622.csv,2025-07-18T12:32:53.413399,3.0,advanced_calculations_v3,exp_v3_000518,2024.00,3.00,1.00,False,False,False,True,40
Ryan,2024-03-06,Mercury,Amazon,,43.07,,SI-LOC & Weight LIfting Belt,,,43.07,,0.00,simple,False,,expense_history_csv,Consolidated_Expense_History_20250622.csv,2025-07-18T12:32:53.413399,3.0,advanced_calculations_v3,exp_v3_000519,2024.00,3.00,1.00,False,False,False,True,40
Ryan,2024-03-07,Mercury,Amazon,,29.61,22.00,"Shea Moisture Curl, CoQ10 & Wrist Brace ($11 for SheaMoisture Curl and Shine Shampoo) - $22 listed to reflect $11",,,29.61,22.00,1.00,simple,False,Mathematical operation: ($11 for SheaMoisture Curl and Shine Shampoo),expense_history_csv,Consolidated_Expense_History_20250622.csv,2025-07-18T12:32:53.413399,3.0,advanced_calculations_v3,exp_v3_000520,2024.00,3.00,1.00,False,False,False,True,60
Ryan,2024-03-07,Mercury,Amazon,,70.00,30.00,"Shea Moisture Hair Conditioner, AmazeFan Leg Stretcher, Stiff Bristle 4 Piece Drill Brush ($15 for Shea Moisture Conditioner) $30 listed to reflect $15",,,70.00,30.00,1.00,simple,False,Mathematical operation: ($15 for Shea Moisture Conditioner),expense_history_csv,Consolidated_Expense_History_20250622.csv,2025-07-18T12:32:53.413399,3.0,advanced_calculations_v3,exp_v3_000521,2024.00,3.00,1.00,False,False,False,True,60
Ryan,2024-03-07,Mercury,Amazon,,43.07,,Amber Glass 1 oz & Water Fountain,,,43.07,,0.00,simple,False,,expense_history_csv,Consolidated_Expense_History_20250622.csv,2025-07-18T12:32:53.413399,3.0,advanced_calculations_v3,exp_v3_000522,2024.00,3.00,1.00,False,False,False,True,40
Ryan,2024-03-08,Mercury,Amazon,,15.08,15.08,"Shea Moisture Hair Conditioner, AmazeFan Leg Stretcher, Stiff Bristle 4 Piece Drill Brush ($15 for Shea Moisture Conditioner) $30 listed to reflect $15",,,15.08,15.08,1.00,simple,False,Mathematical operation: ($15 for Shea Moisture Conditioner),expense_history_csv,Consolidated_Expense_History_20250622.csv,2025-07-18T12:32:53.413399,3.0,advanced_calculations_v3,exp_v3_000523,2024.00,3.00,1.00,False,False,False,True,60
Ryan,2024-02-26,Capital One Savor One,Fry's,,19.45,19.45,Water Bottles,,,19.45,19.45,0.00,simple,False,,expense_history_csv,Consolidated_Expense_History_20250622.csv,2025-07-18T12:32:53.413399,3.0,advanced_calculations_v3,exp_v3_000524,2024.00,2.00,1.00,False,False,False,True,60
Ryan,2024-02-27,Capital One Savor One,Whole Foods Market,,32.10,32.10,Probs wines yo,,,32.10,32.10,0.00,simple,False,,expense_history_csv,Consolidated_Expense_History_20250622.csv,2025-07-18T12:32:53.413399,3.0,advanced_calculations_v3,exp_v3_000525,2024.00,2.00,1.00,False,False,False,True,60
Ryan,2024-02-28,Capital One Savor One,Fry's,,21.24,21.24,Wine,,,21.24,21.24,0.00,simple,False,,expense_history_csv,Consolidated_Expense_History_20250622.csv,2025-07-18T12:32:53.413399,3.0,advanced_calculations_v3,exp_v3_000526,2024.00,2.00,1.00,False,False,False,True,60
Ryan,2024-02-29,Capital One Savor One,Fry's,,17.28,,Rotisserie Chicken,,,17.28,,0.00,simple,False,,expense_history_csv,Consolidated_Expense_History_20250622.csv,2025-07-18T12:32:53.413399,3.0,advanced_calculations_v3,exp_v3_000527,2024.00,2.00,1.00,False,False,False,True,40
Ryan,2024-02-29,Capital One Savor One,Fry's,,19.11,19.11,Wine,,,19.11,19.11,0.00,simple,False,,expense_history_csv,Consolidated_Expense_History_20250622.csv,2025-07-18T12:32:53.413399,3.0,advanced_calculations_v3,exp_v3_000528,2024.00,2.00,1.00,False,False,False,True,60
Ryan,2024-03-01,Capital One Savor One,Fry's,,21.24,21.24,Wine,,,21.24,21.24,0.00,simple,False,,expense_history_csv,Consolidated_Expense_History_20250622.csv,2025-07-18T12:32:53.413399,3.0,advanced_calculations_v3,exp_v3_000529,2024.00,3.00,1.00,False,False,False,True,60
Ryan,2024-03-02,Capital One Savor One,Fry's,,19.11,19.11,Wine,,,19.11,19.11,0.00,simple,False,,expense_history_csv,Consolidated_Expense_History_20250622.csv,2025-07-18T12:32:53.413399,3.0,advanced_calculations_v3,exp_v3_000530,2024.00,3.00,1.00,False,False,False,True,60
Ryan,2024-03-04,Capital One Savor One,Fry's,,50.99,50.99,Wine & Tito's,,,50.99,50.99,0.00,simple,False,,expense_history_csv,Consolidated_Expense_History_20250622.csv,2025-07-18T12:32:53.413399,3.0,advanced_calculations_v3,exp_v3_000531,2024.00,3.00,1.00,False,False,False,True,60
Ryan,2024-03-05,Capital One Savor One,Fry's,,29.78,29.78,Wine,,,29.78,29.78,0.00,simple,False,,expense_history_csv,Consolidated_Expense_History_20250622.csv,2025-07-18T12:32:53.413399,3.0,advanced_calculations_v3,exp_v3_000532,2024.00,3.00,1.00,False,False,False,True,60
Ryan,2024-03-06,Capital One Savor One,Fry's,,29.73,29.73,Wine,,,29.73,29.73,0.00,simple,False,,expense_history_csv,Consolidated_Expense_History_20250622.csv,2025-07-18T12:32:53.413399,3.0,advanced_calculations_v3,exp_v3_000533,2024.00,3.00,1.00,False,False,False,True,60
Ryan,2024-03-07,Capital One Savor One,Fry's,,33.98,33.98,Wine,,,33.98,33.98,0.00,simple,False,,expense_history_csv,Consolidated_Expense_History_20250622.csv,2025-07-18T12:32:53.413399,3.0,advanced_calculations_v3,exp_v3_000534,2024.00,3.00,1.00,False,False,False,True,60
Ryan,2024-03-07,Capital One Savor One,Culver's,,9.49,,Ice Cream (Free for my baaaaaabyyyyyyyyyyyy),,,9.49,,1.00,simple,False,Mathematical operation: (Free for my baaaaaabyyyyyyyyyyyy),expense_history_csv,Consolidated_Expense_History_20250622.csv,2025-07-18T12:32:53.413399,3.0,advanced_calculations_v3,exp_v3_000535,2024.00,3.00,1.00,False,False,False,True,40
Ryan,2024-03-08,Capital One Savor One,Fry's,,6.08,6.08,Summer Sausage,,,6.08,6.08,0.00,simple,False,,expense_history_csv,Consolidated_Expense_History_20250622.csv,2025-07-18T12:32:53.413399,3.0,advanced_calculations_v3,exp_v3_000536,2024.00,3.00,1.00,False,False,False,True,60
Ryan,2024-03-10,Capital One Quicksilver,DoorDash,,34.73,34.73,Five Guys --what about what I paid for Picazzos?,,,34.73,34.73,0.00,simple,False,,expense_history_csv,Consolidated_Expense_History_20250622.csv,2025-07-18T12:32:53.413399,3.0,advanced_calculations_v3,exp_v3_000537,2024.00,3.00,1.00,False,False,False,True,60
Ryan,2024-02-02,Capital One Walmart,Walmart,,6.64,,Batteries,,,6.64,,0.00,simple,False,,expense_history_csv,Consolidated_Expense_History_20250622.csv,2025-07-18T12:32:53.413399,3.0,advanced_calculations_v3,exp_v3_000538,2024.00,2.00,1.00,False,False,False,True,40
Ryan,2024-02-12,Capital One Walmart,Walmart,,58.26,,Flaxseed Oil & L-Theanine,,,58.26,,0.00,simple,False,,expense_history_csv,Consolidated_Expense_History_20250622.csv,2025-07-18T12:32:53.413399,3.0,advanced_calculations_v3,exp_v3_000539,2024.00,2.00,1.00,False,False,False,True,40
Ryan,2024-02-16,Capital One Walmart,Walmart,,13.99,13.99,,,,13.99,13.99,0.00,simple,False,,expense_history_csv,Consolidated_Expense_History_20250622.csv,2025-07-18T12:32:53.413399,3.0,advanced_calculations_v3,exp_v3_000540,2024.00,2.00,1.00,False,False,False,True,40
Ryan,2024-02-06,Credit One x 6396,Fry's,,71.85,71.85,Claussen Pickles & Wine,,,71.85,71.85,0.00,simple,False,,expense_history_csv,Consolidated_Expense_History_20250622.csv,2025-07-18T12:32:53.413399,3.0,advanced_calculations_v3,exp_v3_000541,2024.00,2.00,1.00,False,False,False,True,60
Ryan,2024-02-08,Credit One x 6396,Fry's,,51.60,51.60,Wine,,,51.60,51.60,0.00,simple,False,,expense_history_csv,Consolidated_Expense_History_20250622.csv,2025-07-18T12:32:53.413399,3.0,advanced_calculations_v3,exp_v3_000542,2024.00,2.00,1.00,False,False,False,True,60
Ryan,2024-02-11,Credit One x 6396,Fry's,,54.44,54.44,"Distilled Water, Tito's & Vizzy",,,54.44,54.44,0.00,simple,False,,expense_history_csv,Consolidated_Expense_History_20250622.csv,2025-07-18T12:32:53.413399,3.0,advanced_calculations_v3,exp_v3_000543,2024.00,2.00,1.00,False,False,False,True,60
Ryan,2024-02-11,Credit One x 6396,Fry's,,165.93,165.93,Food,,,165.93,165.93,0.00,simple,False,,expense_history_csv,Consolidated_Expense_History_20250622.csv,2025-07-18T12:32:53.413399,3.0,advanced_calculations_v3,exp_v3_000544,2024.00,2.00,1.00,False,False,False,True,60
Ryan,2024-02-15,Credit One x 6396,Fry's,,34.17,34.17,Wine & White Claw,,,34.17,34.17,0.00,simple,False,,expense_history_csv,Consolidated_Expense_History_20250622.csv,2025-07-18T12:32:53.413399,3.0,advanced_calculations_v3,exp_v3_000545,2024.00,2.00,1.00,False,False,False,True,60
Ryan,2024-02-12,Credit One x 6396,Fry's,,20.45,,Valentines Day Presents (free for my baaaaaaaaaaaaaaaaby),,,20.45,,1.00,simple,False,Mathematical operation: (free for my baaaaaaaaaaaaaaaaby),expense_history_csv,Consolidated_Expense_History_20250622.csv,2025-07-18T12:32:53.413399,3.0,advanced_calculations_v3,exp_v3_000546,2024.00,2.00,1.00,False,False,False,True,40
Ryan,2024-02-12,Credit One x 6396,Fry's,,148.89,,"(freeeeeeeeeee for my babbbbbbbbbbyy, i know she loves that paper towel!)",,,148.89,,1.00,simple,False,"Mathematical operation: (freeeeeeeeeee for my babbbbbbbbbbyy, i know she loves that paper towel!)",expense_history_csv,Consolidated_Expense_History_20250622.csv,2025-07-18T12:32:53.413399,3.0,advanced_calculations_v3,exp_v3_000547,2024.00,2.00,1.00,False,False,False,True,40
Ryan,2024-02-13,Credit One x 6396,Whole Foods Market,,15.09,15.09,,,,15.09,15.09,0.00,simple,False,,expense_history_csv,Consolidated_Expense_History_20250622.csv,2025-07-18T12:32:53.413399,3.0,advanced_calculations_v3,exp_v3_000548,2024.00,2.00,1.00,False,False,False,True,40
Ryan,2024-02-14,Credit One x 6396,Fry's,,40.74,,Beef Jerky & Chocolate (freeeeeeeeeeeeee for my baaaaaabyyyyyyy),,,40.74,,1.00,simple,False,Mathematical operation: (freeeeeeeeeeeeee for my baaaaaabyyyyyyy),expense_history_csv,Consolidated_Expense_History_20250622.csv,2025-07-18T12:32:53.413399,3.0,advanced_calculations_v3,exp_v3_000549,2024.00,2.00,1.00,False,False,False,True,40
Ryan,2024-02-15,Credit One x 6396,Fry's,,17.28,,Rotisserie Chicken & Calipower (freeeeeeeeeee),,,17.28,,1.00,simple,False,Mathematical operation: (freeeeeeeeeee),expense_history_csv,Consolidated_Expense_History_20250622.csv,2025-07-18T12:32:53.413399,3.0,advanced_calculations_v3,exp_v3_000550,2024.00,2.00,1.00,False,False,False,True,40
Ryan,2024-02-17,Credit One x 6396,Fry's,,37.17,37.17,Wine & White Claw,,,37.17,37.17,0.00,simple,False,,expense_history_csv,Consolidated_Expense_History_20250622.csv,2025-07-18T12:32:53.413399,3.0,advanced_calculations_v3,exp_v3_000551,2024.00,2.00,1.00,False,False,False,True,60
Ryan,2024-02-18,Credit One x 6396,Fry's,,22.61,22.61,"PIzza, Honey, Gatorade",,,22.61,22.61,0.00,simple,False,,expense_history_csv,Consolidated_Expense_History_20250622.csv,2025-07-18T12:32:53.413399,3.0,advanced_calculations_v3,exp_v3_000552,2024.00,2.00,1.00,False,False,False,True,60
Ryan,2024-02-19,Credit One x 6396,Fry's,,72.77,72.77,"Caulipower, Polar, Wine, Pizza, Carrots, etc.",,,72.77,72.77,0.00,simple,False,,expense_history_csv,Consolidated_Expense_History_20250622.csv,2025-07-18T12:32:53.413399,3.0,advanced_calculations_v3,exp_v3_000553,2024.00,2.00,1.00,False,False,False,True,60
Ryan,2024-02-20,Credit One x 6396,Whole Foods Market,,30.16,30.16,Probs wines yo,,,30.16,30.16,0.00,simple,False,,expense_history_csv,Consolidated_Expense_History_20250622.csv,2025-07-18T12:32:53.413399,3.0,advanced_calculations_v3,exp_v3_000554,2024.00,2.00,1.00,False,False,False,True,60
Ryan,2024-02-21,Credit One x 6396,Whole Foods Market,,15.62,15.62,Probs wines yo,,,15.62,15.62,0.00,simple,False,,expense_history_csv,Consolidated_Expense_History_20250622.csv,2025-07-18T12:32:53.413399,3.0,advanced_calculations_v3,exp_v3_000555,2024.00,2.00,1.00,False,False,False,True,60
Ryan,2024-02-22,Credit One x 6396,Whole Foods Market,,14.00,14.00,Probs wines yo - how much wine we drinksssss for real,,,14.00,14.00,0.00,simple,False,,expense_history_csv,Consolidated_Expense_History_20250622.csv,2025-07-18T12:32:53.413399,3.0,advanced_calculations_v3,exp_v3_000556,2024.00,2.00,1.00,False,False,False,True,60
Ryan,2024-02-24,Credit One x 6396,Fry's,,19.11,19.11,Wine,,,19.11,19.11,0.00,simple,False,,expense_history_csv,Consolidated_Expense_History_20250622.csv,2025-07-18T12:32:53.413399,3.0,advanced_calculations_v3,exp_v3_000557,2024.00,2.00,1.00,False,False,False,True,60
Ryan,2024-02-24,Credit One x 6396,Fry's,,9.63,9.63,Dinner / Fun,,,9.63,9.63,0.00,simple,False,,expense_history_csv,Consolidated_Expense_History_20250622.csv,2025-07-18T12:32:53.413399,3.0,advanced_calculations_v3,exp_v3_000558,2024.00,2.00,1.00,False,False,False,True,60
Ryan,2024-02-09,Wells Fargo Autograph,Pier 54,,30.73,30.73,Dinner / Fun,,,30.73,30.73,0.00,simple,False,,expense_history_csv,Consolidated_Expense_History_20250622.csv,2025-07-18T12:32:53.413399,3.0,advanced_calculations_v3,exp_v3_000559,2024.00,2.00,1.00,False,False,False,True,60
Ryan,2024-02-10,Wells Fargo Autograph,Cactus Jack,,19.23,19.23,Dinner / Fun,,,19.23,19.23,0.00,simple,False,,expense_history_csv,Consolidated_Expense_History_20250622.csv,2025-07-18T12:32:53.413399,3.0,advanced_calculations_v3,exp_v3_000560,2024.00,2.00,1.00,False,False,False,True,60
Ryan,2024-02-10,Wells Fargo Autograph,Via 313,,32.03,32.03,Dinner / Fun,,,32.03,32.03,0.00,simple,False,,expense_history_csv,Consolidated_Expense_History_20250622.csv,2025-07-18T12:32:53.413399,3.0,advanced_calculations_v3,exp_v3_000561,2024.00,2.00,1.00,False,False,False,True,60
Ryan,2024-02-10,Wells Fargo Autograph,Gus's Fried Chicken,,32.75,32.75,Dinner / Fun,,,32.75,32.75,0.00,simple,False,,expense_history_csv,Consolidated_Expense_History_20250622.csv,2025-07-18T12:32:53.413399,3.0,advanced_calculations_v3,exp_v3_000562,2024.00,2.00,1.00,False,False,False,True,60
Ryan,2024-02-11,Wells Fargo Autograph,The Hub Bar & Grill,,56.78,56.78,Dinner / Fun,,,56.78,56.78,0.00,simple,False,,expense_history_csv,Consolidated_Expense_History_20250622.csv,2025-07-18T12:32:53.413399,3.0,advanced_calculations_v3,exp_v3_000563,2024.00,2.00,1.00,False,False,False,True,60
Ryan,2024-02-11,Wells Fargo Autograph,Wicked Brews,,78.64,78.64,Dinner / Fun,,,78.64,78.64,0.00,simple,False,,expense_history_csv,Consolidated_Expense_History_20250622.csv,2025-07-18T12:32:53.413399,3.0,advanced_calculations_v3,exp_v3_000564,2024.00,2.00,1.00,False,False,False,True,60
Ryan,2024-02-14,Wells Fargo Autograph,King's Fish House,,176.26,176.26,Dinner / Fun,,,176.26,176.26,0.00,simple,False,,expense_history_csv,Consolidated_Expense_History_20250622.csv,2025-07-18T12:32:53.413399,3.0,advanced_calculations_v3,exp_v3_000565,2024.00,2.00,1.00,False,False,False,True,60
Ryan,2024-02-15,Wells Fargo Autograph,In n Out,,13.94,13.94,Dinner / Fun,,,13.94,13.94,0.00,simple,False,,expense_history_csv,Consolidated_Expense_History_20250622.csv,2025-07-18T12:32:53.413399,3.0,advanced_calculations_v3,exp_v3_000566,2024.00,2.00,1.00,False,False,False,True,60
Ryan,2024-02-16,Wells Fargo Autograph,Casa Tempe,,64.86,64.86,Dinner / Fun,,,64.86,64.86,0.00,simple,False,,expense_history_csv,Consolidated_Expense_History_20250622.csv,2025-07-18T12:32:53.413399,3.0,advanced_calculations_v3,exp_v3_000567,2024.00,2.00,1.00,False,False,False,True,60
Ryan,2024-02-17,Wells Fargo Autograph,Lobby Bar,,53.78,53.78,Dinner / Fun,,,53.78,53.78,0.00,simple,False,,expense_history_csv,Consolidated_Expense_History_20250622.csv,2025-07-18T12:32:53.413399,3.0,advanced_calculations_v3,exp_v3_000568,2024.00,2.00,1.00,False,False,False,True,60
Ryan,2024-02-17,Wells Fargo Autograph,Kabuki,,59.24,59.24,Dinner / Fun,,,59.24,59.24,0.00,simple,False,,expense_history_csv,Consolidated_Expense_History_20250622.csv,2025-07-18T12:32:53.413399,3.0,advanced_calculations_v3,exp_v3_000569,2024.00,2.00,1.00,False,False,False,True,60
Ryan,2024-02-23,Wells Fargo Autograph,Pier 54,,22.12,22.12,Dinner / Fun,,,22.12,22.12,0.00,simple,False,,expense_history_csv,Consolidated_Expense_History_20250622.csv,2025-07-18T12:32:53.413399,3.0,advanced_calculations_v3,exp_v3_000570,2024.00,2.00,1.00,False,False,False,True,60
Ryan,2024-02-24,Wells Fargo Autograph,Stamper Cheese,,10.30,10.30,Dinner / Fun,,,10.30,10.30,0.00,simple,False,,expense_history_csv,Consolidated_Expense_History_20250622.csv,2025-07-18T12:32:53.413399,3.0,advanced_calculations_v3,exp_v3_000571,2024.00,2.00,1.00,False,False,False,True,60
Ryan,2024-02-25,Wells Fargo Autograph,Thirsty Lion,,31.00,31.00,Dinner / Fun,,,31.00,31.00,0.00,simple,False,,expense_history_csv,Consolidated_Expense_History_20250622.csv,2025-07-18T12:32:53.413399,3.0,advanced_calculations_v3,exp_v3_000572,2024.00,2.00,1.00,False,False,False,True,60
Ryan,2024-02-25,Wells Fargo Autograph,Netflix,,24.78,24.78,Dinner / Fun,,,24.78,24.78,0.00,simple,False,,expense_history_csv,Consolidated_Expense_History_20250622.csv,2025-07-18T12:32:53.413399,3.0,advanced_calculations_v3,exp_v3_000573,2024.00,2.00,1.00,False,False,False,True,60
Ryan,2024-03-02,Wells Fargo Autograph,Culvers,,20.40,20.40,Dinner / Fun,,,20.40,20.40,0.00,simple,False,,expense_history_csv,Consolidated_Expense_History_20250622.csv,2025-07-18T12:32:53.413399,3.0,advanced_calculations_v3,exp_v3_000574,2024.00,3.00,1.00,False,False,False,True,60
Ryan,2024-03-03,Wells Fargo Autograph,The Hub Bar & Grill,,25.50,25.50,Dinner / Fun,,,25.50,25.50,0.00,simple,False,,expense_history_csv,Consolidated_Expense_History_20250622.csv,2025-07-18T12:32:53.413399,3.0,advanced_calculations_v3,exp_v3_000575,2024.00,3.00,1.00,False,False,False,True,60
Ryan,2024-03-03,Wells Fargo Autograph,The Hub Bar & Grill,,51.31,51.31,Dinner / Fun,,,51.31,51.31,0.00,simple,False,,expense_history_csv,Consolidated_Expense_History_20250622.csv,2025-07-18T12:32:53.413399,3.0,advanced_calculations_v3,exp_v3_000576,2024.00,3.00,1.00,False,False,False,True,60
Ryan,2024-03-09,Wells Fargo Autograph,Snooze,,66.47,66.47,Dinner / Fun,,,66.47,66.47,0.00,simple,False,,expense_history_csv,Consolidated_Expense_History_20250622.csv,2025-07-18T12:32:53.413399,3.0,advanced_calculations_v3,exp_v3_000577,2024.00,3.00,1.00,False,False,False,True,60
Ryan,2024-03-09,Wells Fargo Autograph,Culver's,,11.33,11.33,Dinner / Fun,,,11.33,11.33,0.00,simple,False,,expense_history_csv,Consolidated_Expense_History_20250622.csv,2025-07-18T12:32:53.413399,3.0,advanced_calculations_v3,exp_v3_000578,2024.00,3.00,1.00,False,False,False,True,60
Ryan,2024-03-10,Wells Fargo Autograph,Page Springs Cellars,,19.46,19.46,Dinner / Fun,,,19.46,19.46,0.00,simple,False,,expense_history_csv,Consolidated_Expense_History_20250622.csv,2025-07-18T12:32:53.413399,3.0,advanced_calculations_v3,exp_v3_000579,2024.00,3.00,1.00,False,False,False,True,60
Ryan,2024-03-10,Wells Fargo Autograph,Food 4 Your Skin,,36.22,36.22,Dinner / Fun-- what the heck is this?,,,36.22,36.22,0.00,simple,False,,expense_history_csv,Consolidated_Expense_History_20250622.csv,2025-07-18T12:32:53.413399,3.0,advanced_calculations_v3,exp_v3_000580,2024.00,3.00,1.00,False,False,False,True,60
Ryan,2024-03-10,Wells Fargo Autograph,Downtown Tempe Fou,,35.00,35.00,Dinner / Fun,,,35.00,35.00,0.00,simple,False,,expense_history_csv,Consolidated_Expense_History_20250622.csv,2025-07-18T12:32:53.413399,3.0,advanced_calculations_v3,exp_v3_000581,2024.00,3.00,1.00,False,False,False,True,60
Ryan,2024-03-10,Wells Fargo Autograph,Parking,,10.00,10.00,Dinner / Fun,,,10.00,10.00,0.00,simple,False,,expense_history_csv,Consolidated_Expense_History_20250622.csv,2025-07-18T12:32:53.413399,3.0,advanced_calculations_v3,exp_v3_000582,2024.00,3.00,1.00,False,False,False,True,60
Ryan,2024-02-17,Target Redcard,"Mucus Relief, Luden's Soothing Throat Drops",,11.07,11.07,Dinner / Fun,,,11.07,11.07,0.00,simple,False,,expense_history_csv,Consolidated_Expense_History_20250622.csv,2025-07-18T12:32:53.413399,3.0,advanced_calculations_v3,exp_v3_000583,2024.00,2.00,1.00,False,False,False,True,60
Ryan,2024-03-02,Target Redcard,Float,,32.76,,Dinner / Fun-- I paid for my own,,,32.76,,0.00,simple,False,,expense_history_csv,Consolidated_Expense_History_20250622.csv,2025-07-18T12:32:53.413399,3.0,advanced_calculations_v3,exp_v3_000584,2024.00,3.00,1.00,False,False,False,True,40
Ryan,2024-03-10,Target Redcard,Stainless Steel Mesh Filter,,27.64,27.64,Dinner / Fun -- being returned,,,27.64,27.64,0.00,simple,False,,expense_history_csv,Consolidated_Expense_History_20250622.csv,2025-07-18T12:32:53.413399,3.0,advanced_calculations_v3,exp_v3_000585,2024.00,3.00,1.00,False,False,False,True,60
Ryan,2024-02-22,Kohl's,Statement Balance,,184.55,,"Kohl's Purchases (Full, chairs, etc.) -- already paid months ago",,,184.55,,1.00,simple,False,"Mathematical operation: (Full, chairs, etc.)",expense_history_csv,Consolidated_Expense_History_20250622.csv,2025-07-18T12:32:53.413399,3.0,advanced_calculations_v3,exp_v3_000586,2024.00,2.00,1.00,False,False,False,True,40
Ryan,2024-02-05,Wells Fargo,Cox,,90.00,90.00,Internet,,,90.00,90.00,0.00,simple,False,,expense_history_csv,Consolidated_Expense_History_20250622.csv,2025-07-18T12:32:53.413399,3.0,advanced_calculations_v3,exp_v3_000587,2024.00,2.00,1.00,False,False,False,True,60
Ryan,2024-02-20,Wells Fargo,SRP,,124.61,124.61,Electric,,,124.61,124.61,0.00,simple,False,,expense_history_csv,Consolidated_Expense_History_20250622.csv,2025-07-18T12:32:53.413399,3.0,advanced_calculations_v3,exp_v3_000588,2024.00,2.00,1.00,False,False,False,True,60
Ryan,2024-03-07,Wells Fargo,Cox,,90.00,90.00,Internet,,,90.00,90.00,0.00,simple,False,,expense_history_csv,Consolidated_Expense_History_20250622.csv,2025-07-18T12:32:53.413399,3.0,advanced_calculations_v3,exp_v3_000589,2024.00,3.00,1.00,False,False,False,True,60
Ryan,2024-02-13,Apple Wallet,Bro,,225.00,225.00,Dinner / Fun,,,225.00,225.00,0.00,simple,False,,expense_history_csv,Consolidated_Expense_History_20250622.csv,2025-07-18T12:32:53.413399,3.0,advanced_calculations_v3,exp_v3_000590,2024.00,2.00,1.00,False,False,False,True,60
Ryan,2024-02-23,Apple Wallet,Bro,,225.00,225.00,Dinner / Fun,,,225.00,225.00,0.00,simple,False,,expense_history_csv,Consolidated_Expense_History_20250622.csv,2025-07-18T12:32:53.413399,3.0,advanced_calculations_v3,exp_v3_000591,2024.00,2.00,1.00,False,False,False,True,60
Ryan,2024-02-29,Apple Wallet,Bro,,225.00,225.00,Dinner / Fun,,,225.00,225.00,0.00,simple,False,,expense_history_csv,Consolidated_Expense_History_20250622.csv,2025-07-18T12:32:53.413399,3.0,advanced_calculations_v3,exp_v3_000592,2024.00,2.00,1.00,False,False,False,True,60
Ryan,2024-03-04,Apple Wallet,Fry's,,27.20,27.20,Dinner / Fun,,,27.20,27.20,0.00,simple,False,,expense_history_csv,Consolidated_Expense_History_20250622.csv,2025-07-18T12:32:53.413399,3.0,advanced_calculations_v3,exp_v3_000593,2024.00,3.00,1.00,False,False,False,True,60
Ryan,2024-03-06,Apple Wallet,Bro,,225.00,225.00,Dinner / Fun,,,225.00,225.00,0.00,simple,False,,expense_history_csv,Consolidated_Expense_History_20250622.csv,2025-07-18T12:32:53.413399,3.0,advanced_calculations_v3,exp_v3_000594,2024.00,3.00,1.00,False,False,False,True,60
Ryan,2024-03-11,Apple Wallet,Bro,,225.00,225.00,Dinner / Fun,,,225.00,225.00,0.00,simple,False,,expense_history_csv,Consolidated_Expense_History_20250622.csv,2025-07-18T12:32:53.413399,3.0,advanced_calculations_v3,exp_v3_000595,2024.00,3.00,1.00,False,False,False,True,60
Ryan,2024-02-11,Cash,Rebecca,,220.00,220.00,Dinner / Fun,,,220.00,220.00,0.00,simple,False,,expense_history_csv,Consolidated_Expense_History_20250622.csv,2025-07-18T12:32:53.413399,3.0,advanced_calculations_v3,exp_v3_000596,2024.00,2.00,1.00,False,False,False,True,60
Ryan,2024-02-24,Cash,Rebecca,,220.00,220.00,Dinner / Fun,,,220.00,220.00,0.00,simple,False,,expense_history_csv,Consolidated_Expense_History_20250622.csv,2025-07-18T12:32:53.413399,3.0,advanced_calculations_v3,exp_v3_000597,2024.00,2.00,1.00,False,False,False,True,60
Ryan,2024-03-06,Cash,Rebecca,,220.00,,Freeeee for my babbbbbbbbbbbbbbbbbbby (yayyyyyyyyyyyy),,,220.00,,1.00,simple,False,Mathematical operation: (yayyyyyyyyyyyy),expense_history_csv,Consolidated_Expense_History_20250622.csv,2025-07-18T12:32:53.413399,3.0,advanced_calculations_v3,exp_v3_000598,2024.00,3.00,1.00,False,False,False,True,40
Jordyn,2024-02-21,Chase,Kindle Unlimited,,12.96,12.96,,,,12.96,12.96,0.00,simple,False,,expense_history_csv,Consolidated_Expense_History_20250622.csv,2025-07-18T12:32:53.413399,3.0,advanced_calculations_v3,exp_v3_000599,2024.00,2.00,1.00,False,False,False,True,40
Jordyn,2024-02-21,Bob's,,,72.95,72.95,,,,72.95,72.95,0.00,simple,False,,expense_history_csv,Consolidated_Expense_History_20250622.csv,2025-07-18T12:32:53.413399,3.0,advanced_calculations_v3,exp_v3_000600,2024.00,2.00,1.00,False,False,False,True,40
Jordyn,2024-03-11,Wells Fargo,Seasonings,,37.84,37.84,,,,37.84,37.84,0.00,simple,False,,expense_history_csv,Consolidated_Expense_History_20250622.csv,2025-07-18T12:32:53.413399,3.0,advanced_calculations_v3,exp_v3_000601,2024.00,3.00,1.00,False,False,False,True,40
Jordyn,2024-03-11,,Downtown Tempe (Wine Tasting),,35.00,35.00,,,,35.00,35.00,0.00,simple,False,,expense_history_csv,Consolidated_Expense_History_20250622.csv,2025-07-18T12:32:53.413399,3.0,advanced_calculations_v3,exp_v3_000602,2024.00,3.00,1.00,False,False,False,True,40
Jordyn,2024-03-08,,Espo's,,41.76,41.76,,,,41.76,41.76,0.00,simple,False,,expense_history_csv,Consolidated_Expense_History_20250622.csv,2025-07-18T12:32:53.413399,3.0,advanced_calculations_v3,exp_v3_000603,2024.00,3.00,1.00,False,False,False,True,40
Jordyn,2024-03-06,,Amazon,,27.98,,"Eraser Kit, Beauty Curl",,,27.98,,0.00,simple,False,,expense_history_csv,Consolidated_Expense_History_20250622.csv,2025-07-18T12:32:53.413399,3.0,advanced_calculations_v3,exp_v3_000604,2024.00,3.00,1.00,False,False,False,True,40
Jordyn,2024-03-05,,Amazon,,125.75,,Western Digital HD (Will itemize to right),,,125.75,,1.00,simple,False,Mathematical operation: (Will itemize to right),expense_history_csv,Consolidated_Expense_History_20250622.csv,2025-07-18T12:32:53.413399,3.0,advanced_calculations_v3,exp_v3_000605,2024.00,3.00,1.00,False,False,False,True,40
Jordyn,2024-03-05,,Fry's,,274.67,274.67,,,,274.67,274.67,0.00,simple,False,,expense_history_csv,Consolidated_Expense_History_20250622.csv,2025-07-18T12:32:53.413399,3.0,advanced_calculations_v3,exp_v3_000606,2024.00,3.00,1.00,False,False,False,True,40
Jordyn,2024-03-05,,Pedicure,,41.00,,Ryan pays for this (will itemize to right),,,41.00,,1.00,simple,False,Mathematical operation: (will itemize to right),expense_history_csv,Consolidated_Expense_History_20250622.csv,2025-07-18T12:32:53.413399,3.0,advanced_calculations_v3,exp_v3_000607,2024.00,3.00,1.00,False,False,False,True,40
Jordyn,2024-03-01,,Fry's,,36.50,36.50,,,,36.50,36.50,0.00,simple,False,,expense_history_csv,Consolidated_Expense_History_20250622.csv,2025-07-18T12:32:53.413399,3.0,advanced_calculations_v3,exp_v3_000608,2024.00,3.00,1.00,False,False,False,True,40
Jordyn,2024-02-29,,William Sonoma,,20.67,20.67,,,,20.67,20.67,0.00,simple,False,,expense_history_csv,Consolidated_Expense_History_20250622.csv,2025-07-18T12:32:53.413399,3.0,advanced_calculations_v3,exp_v3_000609,2024.00,2.00,1.00,False,False,False,True,40
Jordyn,2024-02-25,,Fry's,,146.88,146.88,,,,146.88,146.88,0.00,simple,False,,expense_history_csv,Consolidated_Expense_History_20250622.csv,2025-07-18T12:32:53.413399,3.0,advanced_calculations_v3,exp_v3_000610,2024.00,2.00,1.00,False,False,False,True,40
Jordyn,,,24-Feb,,33.50,33.50,,,,33.50,33.50,0.00,simple,False,,expense_history_csv,Consolidated_Expense_History_20250622.csv,2025-07-18T12:32:53.413399,3.0,advanced_calculations_v3,exp_v3_000611,,,,False,False,False,False,0
Jordyn,2024-02-24,,Amazon,,21.53,21.53,Fruit Basket,,,21.53,21.53,0.00,simple,False,,expense_history_csv,Consolidated_Expense_History_20250622.csv,2025-07-18T12:32:53.413399,3.0,advanced_calculations_v3,exp_v3_000612,2024.00,2.00,1.00,False,False,False,True,60
Jordyn,2024-02-24,,Sprouts,,31.47,31.47,,,,31.47,31.47,0.00,simple,False,,expense_history_csv,Consolidated_Expense_History_20250622.csv,2025-07-18T12:32:53.413399,3.0,advanced_calculations_v3,exp_v3_000613,2024.00,2.00,1.00,False,False,False,True,40
Jordyn,2024-02-24,,Over Easy,,59.58,59.58,,,,59.58,59.58,0.00,simple,False,,expense_history_csv,Consolidated_Expense_History_20250622.csv,2025-07-18T12:32:53.413399,3.0,advanced_calculations_v3,exp_v3_000614,2024.00,2.00,1.00,False,False,False,True,40
Jordyn,2024-02-23,,Word of Mouth Grill,,43.19,43.19,,,,43.19,43.19,0.00,simple,False,,expense_history_csv,Consolidated_Expense_History_20250622.csv,2025-07-18T12:32:53.413399,3.0,advanced_calculations_v3,exp_v3_000615,2024.00,2.00,1.00,False,False,False,True,40
Jordyn,2024-02-23,,Whole Foods,,19.35,19.35,,,,19.35,19.35,0.00,simple,False,,expense_history_csv,Consolidated_Expense_History_20250622.csv,2025-07-18T12:32:53.413399,3.0,advanced_calculations_v3,exp_v3_000616,2024.00,2.00,1.00,False,False,False,True,40
Jordyn,2024-02-18,,Whole Foods,,29.38,29.38,,,,29.38,29.38,0.00,simple,False,,expense_history_csv,Consolidated_Expense_History_20250622.csv,2025-07-18T12:32:53.413399,3.0,advanced_calculations_v3,exp_v3_000617,2024.00,2.00,1.00,False,False,False,True,40
Jordyn,2024-02-17,,The Hub,,124.38,124.38,,,,124.38,124.38,0.00,simple,False,,expense_history_csv,Consolidated_Expense_History_20250622.csv,2025-07-18T12:32:53.413399,3.0,advanced_calculations_v3,exp_v3_000618,2024.00,2.00,1.00,False,False,False,True,40
Jordyn,2024-02-17,,Kabuki,,59.24,59.24,,,,59.24,59.24,0.00,simple,False,,expense_history_csv,Consolidated_Expense_History_20250622.csv,2025-07-18T12:32:53.413399,3.0,advanced_calculations_v3,exp_v3_000619,2024.00,2.00,1.00,False,False,False,True,40
Jordyn,2024-02-13,,Fry's,,30.56,30.56,,,,30.56,30.56,0.00,simple,False,,expense_history_csv,Consolidated_Expense_History_20250622.csv,2025-07-18T12:32:53.413399,3.0,advanced_calculations_v3,exp_v3_000620,2024.00,2.00,1.00,False,False,False,True,40
Jordyn,2024-02-12,,Ticket Master (Creed),,261.12,261.12,,,,261.12,261.12,0.00,simple,False,,expense_history_csv,Consolidated_Expense_History_20250622.csv,2025-07-18T12:32:53.413399,3.0,advanced_calculations_v3,exp_v3_000621,2024.00,2.00,1.00,False,False,False,True,40
Jordyn,2024-02-10,,Gus's Fried Chicken,,31.74,31.74,,,,31.74,31.74,0.00,simple,False,,expense_history_csv,Consolidated_Expense_History_20250622.csv,2025-07-18T12:32:53.413399,3.0,advanced_calculations_v3,exp_v3_000622,2024.00,2.00,1.00,False,False,False,True,40
Jordyn,2024-02-10,,Adam and Eve,,131.89,131.89,,,,131.89,131.89,0.00,simple,False,,expense_history_csv,Consolidated_Expense_History_20250622.csv,2025-07-18T12:32:53.413399,3.0,advanced_calculations_v3,exp_v3_000623,2024.00,2.00,1.00,False,False,False,True,40
Jordyn,2024-02-10,,Sprouts,,17.37,17.37,,,,17.37,17.37,0.00,simple,False,,expense_history_csv,Consolidated_Expense_History_20250622.csv,2025-07-18T12:32:53.413399,3.0,advanced_calculations_v3,exp_v3_000624,2024.00,2.00,1.00,False,False,False,True,40
Jordyn,2024-02-10,,Via 313,,28.07,28.07,,,,28.07,28.07,0.00,simple,False,,expense_history_csv,Consolidated_Expense_History_20250622.csv,2025-07-18T12:32:53.413399,3.0,advanced_calculations_v3,exp_v3_000625,2024.00,2.00,1.00,False,False,False,True,40
Jordyn,2024-02-07,,Amazon,,27.47,,Vitamin D & Probiotics,,,27.47,,0.00,simple,False,,expense_history_csv,Consolidated_Expense_History_20250622.csv,2025-07-18T12:32:53.413399,3.0,advanced_calculations_v3,exp_v3_000626,2024.00,2.00,1.00,False,False,False,True,40
Jordyn,2024-02-06,,Caldwell County,,44.61,44.61,,,,44.61,44.61,0.00,simple,False,,expense_history_csv,Consolidated_Expense_History_20250622.csv,2025-07-18T12:32:53.413399,3.0,advanced_calculations_v3,exp_v3_000627,2024.00,2.00,1.00,False,False,False,True,40
Ryan,2024-03-29,Wells Fargo Everyday Checking x3850,SRP,,82.92,82.92,Electric,,,82.92,82.92,0.00,simple,False,,expense_history_csv,Consolidated_Expense_History_20250622.csv,2025-07-18T12:32:53.413399,3.0,advanced_calculations_v3,exp_v3_000628,2024.00,3.00,1.00,False,False,False,True,60
Ryan,2024-04-05,Wells Fargo Everyday Checking x3850,Cox,,90.00,90.00,Internet,,,90.00,90.00,0.00,simple,False,,expense_history_csv,Consolidated_Expense_History_20250622.csv,2025-07-18T12:32:53.413399,3.0,advanced_calculations_v3,exp_v3_000629,2024.00,4.00,2.00,False,False,False,True,60
Ryan,2024-04-17,Wells Fargo Everyday Checking x3850,SRP,,77.71,77.71,Electric,,,77.71,77.71,0.00,simple,False,,expense_history_csv,Consolidated_Expense_History_20250622.csv,2025-07-18T12:32:53.413399,3.0,advanced_calculations_v3,exp_v3_000630,2024.00,4.00,2.00,False,False,False,True,60
Ryan,2024-04-05,Wells Fargo Everyday Checking x3850,Cox,,90.00,90.00,Internet,,,90.00,90.00,0.00,simple,False,,expense_history_csv,Consolidated_Expense_History_20250622.csv,2025-07-18T12:32:53.413399,3.0,advanced_calculations_v3,exp_v3_000631,2024.00,4.00,2.00,False,False,False,True,60
Ryan,2024-04-15,Wells Fargo Everyday Checking x3850,Target,,45.00,45.00,,,,45.00,45.00,0.00,simple,False,,expense_history_csv,Consolidated_Expense_History_20250622.csv,2025-07-18T12:32:53.413399,3.0,advanced_calculations_v3,exp_v3_000632,2024.00,4.00,2.00,False,False,False,True,40
Ryan,2024-04-17,Wells Fargo Everyday Checking x3850,SRP,,77.71,77.71,Electric,,,77.71,77.71,0.00,simple,False,,expense_history_csv,Consolidated_Expense_History_20250622.csv,2025-07-18T12:32:53.413399,3.0,advanced_calculations_v3,exp_v3_000633,2024.00,4.00,2.00,False,False,False,True,60
Ryan,2024-05-06,Wells Fargo Everyday Checking x3850,Cox,,90.00,90.00,Internet,,,90.00,90.00,0.00,simple,False,,expense_history_csv,Consolidated_Expense_History_20250622.csv,2025-07-18T12:32:53.413399,3.0,advanced_calculations_v3,exp_v3_000634,2024.00,5.00,2.00,False,False,False,True,60
Ryan,2024-05-09,Wells Fargo Everyday Checking x3850,Target Card,,76.11,76.11,,,,76.11,76.11,0.00,simple,False,,expense_history_csv,Consolidated_Expense_History_20250622.csv,2025-07-18T12:32:53.413399,3.0,advanced_calculations_v3,exp_v3_000635,2024.00,5.00,2.00,False,False,False,True,40
Ryan,2024-05-13,Wells Fargo Everyday Checking x3850,Premium Parking,,8.99,8.99,,,,8.99,8.99,0.00,simple,False,,expense_history_csv,Consolidated_Expense_History_20250622.csv,2025-07-18T12:32:53.413399,3.0,advanced_calculations_v3,exp_v3_000636,2024.00,5.00,2.00,False,False,False,True,40
Ryan,2024-05-17,Wells Fargo Everyday Checking x3850,SRP,,81.86,81.86,,,,81.86,81.86,0.00,simple,False,,expense_history_csv,Consolidated_Expense_History_20250622.csv,2025-07-18T12:32:53.413399,3.0,advanced_calculations_v3,exp_v3_000637,2024.00,5.00,2.00,False,False,False,True,40
Ryan,2024-06-05,Wells Fargo Everyday Checking x3850,Cox,,106.00,106.00,Internet,,,106.00,106.00,0.00,simple,False,,expense_history_csv,Consolidated_Expense_History_20250622.csv,2025-07-18T12:32:53.413399,3.0,advanced_calculations_v3,exp_v3_000638,2024.00,6.00,2.00,False,False,False,True,60
Ryan,2024-06-10,Wells Fargo Everyday Checking x3850,Target,,168.15,168.15,,,,168.15,168.15,0.00,simple,False,,expense_history_csv,Consolidated_Expense_History_20250622.csv,2025-07-18T12:32:53.413399,3.0,advanced_calculations_v3,exp_v3_000639,2024.00,6.00,2.00,False,False,False,True,40
Ryan,2024-06-20,EVERYDAY CHECKING ...3850,SRP SUREPAY-S1 240619 XXXXX9006 ZIMMERMEN RYAN W [Srp Surepay-s],,137.42,137.42,,,,137.42,137.42,0.00,simple,False,,expense_history_csv,Consolidated_Expense_History_20250622.csv,2025-07-18T12:32:53.413399,3.0,advanced_calculations_v3,exp_v3_000640,2024.00,6.00,2.00,False,False,False,True,40
Ryan,2024-06-24,EVERYDAY CHECKING ...3850,Best Buy,,146.00,,,,,146.00,,0.00,simple,False,,expense_history_csv,Consolidated_Expense_History_20250622.csv,2025-07-18T12:32:53.413399,3.0,advanced_calculations_v3,exp_v3_000641,2024.00,6.00,2.00,False,False,False,True,20
Ryan,2024-06-24,EVERYDAY CHECKING ...3850,Menards,,20.00,20.00,,,,20.00,20.00,0.00,simple,False,,expense_history_csv,Consolidated_Expense_History_20250622.csv,2025-07-18T12:32:53.413399,3.0,advanced_calculations_v3,exp_v3_000642,2024.00,6.00,2.00,False,False,False,True,40
Ryan,2024-06-26,EVERYDAY CHECKING ...3850,MONEY TRANSFER AUTHORIZED ON 06/24 APPLE CASH SENT MO 1INFINITELOOP CA S304176797747875 CARD 0968,,62.85,,,,,62.85,,0.00,simple,False,,expense_history_csv,Consolidated_Expense_History_20250622.csv,2025-07-18T12:32:53.413399,3.0,advanced_calculations_v3,exp_v3_000643,2024.00,6.00,2.00,False,False,False,True,20
Ryan,2024-06-27,EVERYDAY CHECKING ...3850,MONEY TRANSFER AUTHORIZED ON 06/25 APPLE CASH SENT MO 1INFINITELOOP CA S304178123094455 CARD 0968,,5.00,,,,,5.00,,0.00,simple,False,,expense_history_csv,Consolidated_Expense_History_20250622.csv,2025-07-18T12:32:53.413399,3.0,advanced_calculations_v3,exp_v3_000644,2024.00,6.00,2.00,False,False,False,True,20
Ryan,2024-06-27,EVERYDAY CHECKING ...3850,MONEY TRANSFER AUTHORIZED ON 06/25 APPLE CASH SENT MO 1INFINITELOOP CA S584178121977703 CARD 0968,,220.00,,,,,220.00,,0.00,simple,False,,expense_history_csv,Consolidated_Expense_History_20250622.csv,2025-07-18T12:32:53.413399,3.0,advanced_calculations_v3,exp_v3_000645,2024.00,6.00,2.00,False,False,False,True,20
Ryan,2024-06-28,EVERYDAY CHECKING ...3850,RECURRING PAYMENT AUTHORIZED ON 06/27 AFFIRM * PAY T73VT CA S464179399248594 CARD 0968 [Affirm],,21.12,,,,,21.12,,0.00,simple,False,,expense_history_csv,Consolidated_Expense_History_20250622.csv,2025-07-18T12:32:53.413399,3.0,advanced_calculations_v3,exp_v3_000646,2024.00,6.00,2.00,False,False,False,True,20
Ryan,2024-07-01,EVERYDAY CHECKING ...3850,PURCHASE AUTHORIZED ON 06/29 PARKMOBILE GA S584182015221078 CARD 0968 [Parkmobile],,6.00,6.00,,,,6.00,6.00,0.00,simple,False,,expense_history_csv,Consolidated_Expense_History_20250622.csv,2025-07-18T12:32:53.413399,3.0,advanced_calculations_v3,exp_v3_000647,2024.00,7.00,3.00,False,False,False,True,40
Ryan,2024-03-12,Capital One Quicksilver,Door Dash,,34.73,34.73,Five Guys,,,34.73,34.73,0.00,simple,False,,expense_history_csv,Consolidated_Expense_History_20250622.csv,2025-07-18T12:32:53.413399,3.0,advanced_calculations_v3,exp_v3_000648,2024.00,3.00,1.00,False,False,False,True,60
Ryan,2024-03-12,Capital One Quicksilver,Door Dash,,22.73,22.73,Picazzo's,,,22.73,22.73,0.00,simple,False,,expense_history_csv,Consolidated_Expense_History_20250622.csv,2025-07-18T12:32:53.413399,3.0,advanced_calculations_v3,exp_v3_000649,2024.00,3.00,1.00,False,False,False,True,60
Ryan,2024-03-12,Capital One Quicksilver,Walgreens,,42.51,,,,,42.51,,0.00,simple,False,,expense_history_csv,Consolidated_Expense_History_20250622.csv,2025-07-18T12:32:53.413399,3.0,advanced_calculations_v3,exp_v3_000650,2024.00,3.00,1.00,False,False,False,True,20
Ryan,2024-04-08,Capital One Quicksilver,Pixlr,,5.59,5.59,OnlyFan's Photo Editing,,,5.59,5.59,0.00,simple,False,,expense_history_csv,Consolidated_Expense_History_20250622.csv,2025-07-18T12:32:53.413399,3.0,advanced_calculations_v3,exp_v3_000651,2024.00,4.00,2.00,False,False,False,True,60
Ryan,2024-04-22,Capital One Quicksilver,DD DOORDASH SPINATOSP [Spinatosp],,9.98,9.98,Spinatos,,,9.98,9.98,0.00,simple,False,,expense_history_csv,Consolidated_Expense_History_20250622.csv,2025-07-18T12:32:53.413399,3.0,advanced_calculations_v3,exp_v3_000652,2024.00,4.00,2.00,False,False,False,True,60
Ryan,2024-05-07,Capital One Quicksilver,DD DOORDASH FIVEGUYSB [Five Guys],,52.72,52.72,Five Guys,,,52.72,52.72,0.00,simple,False,,expense_history_csv,Consolidated_Expense_History_20250622.csv,2025-07-18T12:32:53.413399,3.0,advanced_calculations_v3,exp_v3_000653,2024.00,5.00,2.00,False,False,False,True,60
Ryan,2024-06-10,Capital One Quicksilver,DD *DOORDASHDASHPASS [Dashpass],,4.99,4.99,Dash Pass,,,4.99,4.99,0.00,simple,False,,expense_history_csv,Consolidated_Expense_History_20250622.csv,2025-07-18T12:32:53.413399,3.0,advanced_calculations_v3,exp_v3_000654,2024.00,6.00,2.00,False,False,False,True,60
Ryan,2024-06-11,Capital One Quicksilver,DD *DOORDASH TOTALWINE [Total Wine & More],,22.41,22.41,Total Wine,,,22.41,22.41,0.00,simple,False,,expense_history_csv,Consolidated_Expense_History_20250622.csv,2025-07-18T12:32:53.413399,3.0,advanced_calculations_v3,exp_v3_000655,2024.00,6.00,2.00,False,False,False,True,60
Ryan,2024-06-11,Capital One Quicksilver,DD DOORDASH SPINATOSP [Spinatosp],,44.30,44.30,Spinatos,,,44.30,44.30,0.00,simple,False,,expense_history_csv,Consolidated_Expense_History_20250622.csv,2025-07-18T12:32:53.413399,3.0,advanced_calculations_v3,exp_v3_000656,2024.00,6.00,2.00,False,False,False,True,60
Ryan,2024-06-11,Capital One Quicksilver,DD DOORDASH TARGET [Target],,34.56,34.56,"Target - Water, etc.",,,34.56,34.56,0.00,simple,False,,expense_history_csv,Consolidated_Expense_History_20250622.csv,2025-07-18T12:32:53.413399,3.0,advanced_calculations_v3,exp_v3_000657,2024.00,6.00,2.00,False,False,False,True,60
,2024-07-01,,,,38.45,,,,,38.45,,0.00,simple,False,,expense_history_csv,Consolidated_Expense_History_20250622.csv,2025-07-18T12:32:53.413399,3.0,advanced_calculations_v3,exp_v3_000658,2024.00,7.00,3.00,False,False,False,False,-20
Ryan,2024-03-12,Capital One Savor One,Fry's,,40.59,40.59,"PIzza, Wine, Parm Cheese",,,40.59,40.59,0.00,simple,False,,expense_history_csv,Consolidated_Expense_History_20250622.csv,2025-07-18T12:32:53.413399,3.0,advanced_calculations_v3,exp_v3_000659,2024.00,3.00,1.00,False,False,False,True,60
Ryan,2024-03-14,Capital One Savor One,Fry's,,29.32,29.32,"Asparagus, Wine",,,29.32,29.32,0.00,simple,False,,expense_history_csv,Consolidated_Expense_History_20250622.csv,2025-07-18T12:32:53.413399,3.0,advanced_calculations_v3,exp_v3_000660,2024.00,3.00,1.00,False,False,False,True,60
Ryan,2024-03-15,Capital One Savor One,Fry's,,13.19,13.19,"Sargento Cheese, Rotisserie Chicken",,,13.19,13.19,0.00,simple,False,,expense_history_csv,Consolidated_Expense_History_20250622.csv,2025-07-18T12:32:53.413399,3.0,advanced_calculations_v3,exp_v3_000661,2024.00,3.00,1.00,False,False,False,True,60
Ryan,2024-03-15,Capital One Savor One,Fry's,,31.78,31.78,"Oxi-Clean, Light Bulbs",,,31.78,31.78,0.00,simple,False,,expense_history_csv,Consolidated_Expense_History_20250622.csv,2025-07-18T12:32:53.413399,3.0,advanced_calculations_v3,exp_v3_000662,2024.00,3.00,1.00,False,False,False,True,60
Ryan,2024-03-16,Capital One Savor One,Fry's,,23.36,23.36,Wine,,,23.36,23.36,0.00,simple,False,,expense_history_csv,Consolidated_Expense_History_20250622.csv,2025-07-18T12:32:53.413399,3.0,advanced_calculations_v3,exp_v3_000663,2024.00,3.00,1.00,False,False,False,True,60
Ryan,2024-03-18,Capital One Savor One,Butler Amusements Inc.,,10.00,10.00,Ostrich Festival,,,10.00,10.00,0.00,simple,False,,expense_history_csv,Consolidated_Expense_History_20250622.csv,2025-07-18T12:32:53.413399,3.0,advanced_calculations_v3,exp_v3_000664,2024.00,3.00,1.00,False,False,False,True,60
Ryan,2024-03-18,Capital One Savor One,Butler Amusements Inc.,,20.00,20.00,Ostrich Festival,,,20.00,20.00,0.00,simple,False,,expense_history_csv,Consolidated_Expense_History_20250622.csv,2025-07-18T12:32:53.413399,3.0,advanced_calculations_v3,exp_v3_000665,2024.00,3.00,1.00,False,False,False,True,60
Ryan,2024-03-18,Capital One Savor One,Butler Amusements Inc.,,30.00,30.00,Ostrich Festival,,,30.00,30.00,0.00,simple,False,,expense_history_csv,Consolidated_Expense_History_20250622.csv,2025-07-18T12:32:53.413399,3.0,advanced_calculations_v3,exp_v3_000666,2024.00,3.00,1.00,False,False,False,True,60
Ryan,2024-03-18,Capital One Savor One,Fry's,,25.93,25.93,"Pizza, Wine",,,25.93,25.93,0.00,simple,False,,expense_history_csv,Consolidated_Expense_History_20250622.csv,2025-07-18T12:32:53.413399,3.0,advanced_calculations_v3,exp_v3_000667,2024.00,3.00,1.00,False,False,False,True,60
Ryan,2024-03-18,Capital One Savor One,Fry's,,50.99,50.99,Unknown,,,50.99,50.99,0.00,simple,False,,expense_history_csv,Consolidated_Expense_History_20250622.csv,2025-07-18T12:32:53.413399,3.0,advanced_calculations_v3,exp_v3_000668,2024.00,3.00,1.00,False,False,False,True,60
Ryan,2024-03-19,Capital One Savor One,Fry's,,23.36,23.36,Wine,,,23.36,23.36,0.00,simple,False,,expense_history_csv,Consolidated_Expense_History_20250622.csv,2025-07-18T12:32:53.413399,3.0,advanced_calculations_v3,exp_v3_000669,2024.00,3.00,1.00,False,False,False,True,60
Ryan,2024-03-19,Capital One Savor One,Whole Foods,,15.09,15.09,Wine,,,15.09,15.09,0.00,simple,False,,expense_history_csv,Consolidated_Expense_History_20250622.csv,2025-07-18T12:32:53.413399,3.0,advanced_calculations_v3,exp_v3_000670,2024.00,3.00,1.00,False,False,False,True,60
Ryan,2024-03-20,Capital One Savor One,Fry's,,23.36,23.36,Wine,,,23.36,23.36,0.00,simple,False,,expense_history_csv,Consolidated_Expense_History_20250622.csv,2025-07-18T12:32:53.413399,3.0,advanced_calculations_v3,exp_v3_000671,2024.00,3.00,1.00,False,False,False,True,60
Ryan,2024-03-22,Capital One Savor One,Fry's,,31.78,31.78,Wine,,,31.78,31.78,0.00,simple,False,,expense_history_csv,Consolidated_Expense_History_20250622.csv,2025-07-18T12:32:53.413399,3.0,advanced_calculations_v3,exp_v3_000672,2024.00,3.00,1.00,False,False,False,True,60
Ryan,2024-04-17,Capital One Savor One,Fry's,,19.12,19.12,White Claw,,,19.12,19.12,0.00,simple,False,,expense_history_csv,Consolidated_Expense_History_20250622.csv,2025-07-18T12:32:53.413399,3.0,advanced_calculations_v3,exp_v3_000673,2024.00,4.00,2.00,False,False,False,True,60
Ryan,2024-04-18,Capital One Savor One,Fry's,,20.43,20.43,Wine,,,20.43,20.43,0.00,simple,False,,expense_history_csv,Consolidated_Expense_History_20250622.csv,2025-07-18T12:32:53.413399,3.0,advanced_calculations_v3,exp_v3_000674,2024.00,4.00,2.00,False,False,False,True,60
Ryan,2024-04-18,Capital One Savor One,Fry's Food and Drug,,19.12,19.12,White Claw,,,19.12,19.12,0.00,simple,False,,expense_history_csv,Consolidated_Expense_History_20250622.csv,2025-07-18T12:32:53.413399,3.0,advanced_calculations_v3,exp_v3_000675,2024.00,4.00,2.00,False,False,False,True,60
Ryan,2024-04-19,Capital One Savor One,Fry's Food and Drug,,20.43,20.43,White Claw,,,20.43,20.43,0.00,simple,False,,expense_history_csv,Consolidated_Expense_History_20250622.csv,2025-07-18T12:32:53.413399,3.0,advanced_calculations_v3,exp_v3_000676,2024.00,4.00,2.00,False,False,False,True,60
Ryan,2024-04-20,Capital One Savor One,Fry's Food and Drug,,19.12,19.12,White Claw,,,19.12,19.12,0.00,simple,False,,expense_history_csv,Consolidated_Expense_History_20250622.csv,2025-07-18T12:32:53.413399,3.0,advanced_calculations_v3,exp_v3_000677,2024.00,4.00,2.00,False,False,False,True,60
Ryan,2024-04-20,Capital One Savor One,Trader Joe's,,15.37,15.37,Wine,,,15.37,15.37,0.00,simple,False,,expense_history_csv,Consolidated_Expense_History_20250622.csv,2025-07-18T12:32:53.413399,3.0,advanced_calculations_v3,exp_v3_000678,2024.00,4.00,2.00,False,False,False,True,60
Ryan,2024-04-23,Capital One Savor One,Fry's Food and Drug,,83.87,83.87,"Charmin, Chaleston Chew, Swedish Fish, Banana, Onion, Chicken, Sushi",,,83.87,83.87,0.00,simple,False,,expense_history_csv,Consolidated_Expense_History_20250622.csv,2025-07-18T12:32:53.413399,3.0,advanced_calculations_v3,exp_v3_000679,2024.00,4.00,2.00,False,False,False,True,60
Ryan,2024-04-24,Capital One Savor One,Fry's Food and Drug,,19.12,19.12,White Claw,,,19.12,19.12,0.00,simple,False,,expense_history_csv,Consolidated_Expense_History_20250622.csv,2025-07-18T12:32:53.413399,3.0,advanced_calculations_v3,exp_v3_000680,2024.00,4.00,2.00,False,False,False,True,60
Ryan,2024-04-24,Capital One Savor One,Whole Foods,,15.09,15.09,Wine,,,15.09,15.09,0.00,simple,False,,expense_history_csv,Consolidated_Expense_History_20250622.csv,2025-07-18T12:32:53.413399,3.0,advanced_calculations_v3,exp_v3_000681,2024.00,4.00,2.00,False,False,False,True,60
Ryan,2024-04-25,Capital One Savor One,Fry's Food and Drug,,59.99,59.99,"Chicken, Wine",,,59.99,59.99,0.00,simple,False,,expense_history_csv,Consolidated_Expense_History_20250622.csv,2025-07-18T12:32:53.413399,3.0,advanced_calculations_v3,exp_v3_000682,2024.00,4.00,2.00,False,False,False,True,60
Ryan,2024-04-26,Capital One Savor One,Fry's Food and Drug,,32.08,32.08,"Wine, White Claw",,,32.08,32.08,0.00,simple,False,,expense_history_csv,Consolidated_Expense_History_20250622.csv,2025-07-18T12:32:53.413399,3.0,advanced_calculations_v3,exp_v3_000683,2024.00,4.00,2.00,False,False,False,True,60
Ryan,2024-04-27,Capital One Savor One,Fry's Food and Drug,,40.57,40.57,Wine,,,40.57,40.57,0.00,simple,False,,expense_history_csv,Consolidated_Expense_History_20250622.csv,2025-07-18T12:32:53.413399,3.0,advanced_calculations_v3,exp_v3_000684,2024.00,4.00,2.00,False,False,False,True,60
Ryan,2024-05-02,Capital One Savor One,Fry's Food and Drug,,54.04,54.04,"White Claw, Wine, Cheese",,,54.04,54.04,0.00,simple,False,,expense_history_csv,Consolidated_Expense_History_20250622.csv,2025-07-18T12:32:53.413399,3.0,advanced_calculations_v3,exp_v3_000685,2024.00,5.00,2.00,False,False,False,True,60
Ryan,2024-05-03,Capital One Savor One,Fry's Food and Drug,,37.96,27.96,"Water, Chicken, Wine",,,37.96,27.96,0.00,simple,False,,expense_history_csv,Consolidated_Expense_History_20250622.csv,2025-07-18T12:32:53.413399,3.0,advanced_calculations_v3,exp_v3_000686,2024.00,5.00,2.00,False,False,False,True,60
Ryan,2024-05-04,Capital One Savor One,Fry's Food and Drug,,49.08,49.08,"White Claw, Wine, Cheese",,,49.08,49.08,0.00,simple,False,,expense_history_csv,Consolidated_Expense_History_20250622.csv,2025-07-18T12:32:53.413399,3.0,advanced_calculations_v3,exp_v3_000687,2024.00,5.00,2.00,False,False,False,True,60
Ryan,2024-05-06,Capital One Savor One,Fry's Food and Drug,,45.68,45.68,"Cutwater, Wine, White Claw",,,45.68,45.68,0.00,simple,False,,expense_history_csv,Consolidated_Expense_History_20250622.csv,2025-07-18T12:32:53.413399,3.0,advanced_calculations_v3,exp_v3_000688,2024.00,5.00,2.00,False,False,False,True,60
Ryan,2024-05-07,Capital One Savor One,Fry's Food and Drug,,59.93,49.93,"Chicken, Granola, Banana, Luna Bars, Water, Wine",,,59.93,49.93,0.00,simple,False,,expense_history_csv,Consolidated_Expense_History_20250622.csv,2025-07-18T12:32:53.413399,3.0,advanced_calculations_v3,exp_v3_000689,2024.00,5.00,2.00,False,False,False,True,60
Ryan,2024-05-08,Capital One Savor One,Fry's Food and Drug,,34.45,34.45,"Distilled Water, Carrots, Wine, White Claw",,,34.45,34.45,0.00,simple,False,,expense_history_csv,Consolidated_Expense_History_20250622.csv,2025-07-18T12:32:53.413399,3.0,advanced_calculations_v3,exp_v3_000690,2024.00,5.00,2.00,False,False,False,True,60
Ryan,2024-05-09,Capital One Savor One,Fry's Food and Drug,,45.42,45.42,"PIckles, Wine, White Claw",,,45.42,45.42,0.00,simple,False,,expense_history_csv,Consolidated_Expense_History_20250622.csv,2025-07-18T12:32:53.413399,3.0,advanced_calculations_v3,exp_v3_000691,2024.00,5.00,2.00,False,False,False,True,60
Ryan,2024-05-13,Capital One Savor One,Fry's Food and Drug,,20.59,,"Yogurt, Cetaphil",,,20.59,,0.00,simple,False,,expense_history_csv,Consolidated_Expense_History_20250622.csv,2025-07-18T12:32:53.413399,3.0,advanced_calculations_v3,exp_v3_000692,2024.00,5.00,2.00,False,False,False,True,40
Ryan,2024-05-13,Capital One Savor One,Fry's Food and Drug,,70.22,70.22,"Luna Bars, Chicken, White Claw, Wine",,,70.22,70.22,0.00,simple,False,,expense_history_csv,Consolidated_Expense_History_20250622.csv,2025-07-18T12:32:53.413399,3.0,advanced_calculations_v3,exp_v3_000693,2024.00,5.00,2.00,False,False,False,True,60
Ryan,2024-05-14,Capital One Savor One,Fry's Food and Drug,,51.94,51.94,"Whtie Claw, Wine, Distilled Water",,,51.94,51.94,0.00,simple,False,,expense_history_csv,Consolidated_Expense_History_20250622.csv,2025-07-18T12:32:53.413399,3.0,advanced_calculations_v3,exp_v3_000694,2024.00,5.00,2.00,False,False,False,True,60
Ryan,2024-05-15,Capital One Savor One,Fry's Food and Drug,,49.02,49.02,"Chicken, Dental Floss, Wine",,,49.02,49.02,0.00,simple,False,,expense_history_csv,Consolidated_Expense_History_20250622.csv,2025-07-18T12:32:53.413399,3.0,advanced_calculations_v3,exp_v3_000695,2024.00,5.00,2.00,False,False,False,True,60
Ryan,2024-05-16,Capital One Savor One,Fry's Food and Drug,,38.55,38.55,Wine,,,38.55,38.55,0.00,simple,False,,expense_history_csv,Consolidated_Expense_History_20250622.csv,2025-07-18T12:32:53.413399,3.0,advanced_calculations_v3,exp_v3_000696,2024.00,5.00,2.00,False,False,False,True,60
Ryan,2024-05-17,Capital One Savor One,Fry's Food and Drug,,37.38,37.38,Wine,,,37.38,37.38,0.00,simple,False,,expense_history_csv,Consolidated_Expense_History_20250622.csv,2025-07-18T12:32:53.413399,3.0,advanced_calculations_v3,exp_v3_000697,2024.00,5.00,2.00,False,False,False,True,60
Ryan,2024-05-18,Capital One Savor One,Fry's Food and Drug,,49.07,49.07,Wine,,,49.07,49.07,0.00,simple,False,,expense_history_csv,Consolidated_Expense_History_20250622.csv,2025-07-18T12:32:53.413399,3.0,advanced_calculations_v3,exp_v3_000698,2024.00,5.00,2.00,False,False,False,True,60
Ryan,2024-05-20,Capital One Savor One,Fry's Food and Drug,,41.50,41.50,"Polar Seltzers, Oikos Yogurt, Water, White Claw",,,41.50,41.50,0.00,simple,False,,expense_history_csv,Consolidated_Expense_History_20250622.csv,2025-07-18T12:32:53.413399,3.0,advanced_calculations_v3,exp_v3_000699,2024.00,5.00,2.00,False,False,False,True,60
Ryan,2024-05-21,Capital One Savor One,Fry's Food and Drug,,39.25,39.25,"Chicken, Granola, Luna Bars, Bananas, Lysol",,,39.25,39.25,0.00,simple,False,,expense_history_csv,Consolidated_Expense_History_20250622.csv,2025-07-18T12:32:53.413399,3.0,advanced_calculations_v3,exp_v3_000700,2024.00,5.00,2.00,False,False,False,True,60
Ryan,2024-05-21,Capital One Savor One,Fry's Food and Drug,,53.51,53.51,"Wine, White Claw",,,53.51,53.51,0.00,simple,False,,expense_history_csv,Consolidated_Expense_History_20250622.csv,2025-07-18T12:32:53.413399,3.0,advanced_calculations_v3,exp_v3_000701,2024.00,5.00,2.00,False,False,False,True,60
Ryan,2024-05-22,Capital One Savor One,Fry's Food and Drug,,49.79,49.79,"Oikos, Carrots, Pickles, Wine",,,49.79,49.79,0.00,simple,False,,expense_history_csv,Consolidated_Expense_History_20250622.csv,2025-07-18T12:32:53.413399,3.0,advanced_calculations_v3,exp_v3_000702,2024.00,5.00,2.00,False,False,False,True,60
Ryan,2024-06-11,Capital One Savor One,Fry's Food and Drug,,48.52,48.52,"Haribo, Pizza, White Claw, Chicken",,,48.52,48.52,0.00,simple,False,,expense_history_csv,Consolidated_Expense_History_20250622.csv,2025-07-18T12:32:53.413399,3.0,advanced_calculations_v3,exp_v3_000703,2024.00,6.00,2.00,False,False,False,True,60
Ryan,2024-06-17,Capital One Savor One,Fry's Food and Drug,,30.36,30.36,Wine,,,30.36,30.36,0.00,simple,False,,expense_history_csv,Consolidated_Expense_History_20250622.csv,2025-07-18T12:32:53.413399,3.0,advanced_calculations_v3,exp_v3_000704,2024.00,6.00,2.00,False,False,False,True,60
Ryan,2024-06-17,SavorOne,Uber,,10.18,10.18,,,,10.18,10.18,0.00,simple,False,,expense_history_csv,Consolidated_Expense_History_20250622.csv,2025-07-18T12:32:53.413399,3.0,advanced_calculations_v3,exp_v3_000705,2024.00,6.00,2.00,False,False,False,True,40
Ryan,2024-06-18,SavorOne,Fry's Food and Drug,,30.36,30.36,Wine / Food,,,30.36,30.36,0.00,simple,False,,expense_history_csv,Consolidated_Expense_History_20250622.csv,2025-07-18T12:32:53.413399,3.0,advanced_calculations_v3,exp_v3_000706,2024.00,6.00,2.00,False,False,False,True,60
Ryan,2024-06-19,SavorOne,Fry's Food and Drug,,40.11,40.11,Wine / Food,,,40.11,40.11,0.00,simple,False,,expense_history_csv,Consolidated_Expense_History_20250622.csv,2025-07-18T12:32:53.413399,3.0,advanced_calculations_v3,exp_v3_000707,2024.00,6.00,2.00,False,False,False,True,60
Ryan,2024-06-20,SavorOne,Fry's Food and Drug,,28.25,28.25,,,,28.25,28.25,0.00,simple,False,,expense_history_csv,Consolidated_Expense_History_20250622.csv,2025-07-18T12:32:53.413399,3.0,advanced_calculations_v3,exp_v3_000708,2024.00,6.00,2.00,False,False,False,True,40
Ryan,2024-06-29,SavorOne,Uber,,3.00,3.00,,,,3.00,3.00,0.00,simple,False,,expense_history_csv,Consolidated_Expense_History_20250622.csv,2025-07-18T12:32:53.413399,3.0,advanced_calculations_v3,exp_v3_000709,2024.00,6.00,2.00,False,False,False,True,40
Ryan,2024-06-29,SavorOne,Uber,,5.56,5.56,,,,5.56,5.56,0.00,simple,False,,expense_history_csv,Consolidated_Expense_History_20250622.csv,2025-07-18T12:32:53.413399,3.0,advanced_calculations_v3,exp_v3_000710,2024.00,6.00,2.00,False,False,False,True,40
Ryan,2024-06-29,SavorOne,Uber,,8.88,8.88,,,,8.88,8.88,0.00,simple,False,,expense_history_csv,Consolidated_Expense_History_20250622.csv,2025-07-18T12:32:53.413399,3.0,advanced_calculations_v3,exp_v3_000711,2024.00,6.00,2.00,False,False,False,True,40
Ryan,2024-06-29,SavorOne,Uber,,11.44,11.44,,,,11.44,11.44,0.00,simple,False,,expense_history_csv,Consolidated_Expense_History_20250622.csv,2025-07-18T12:32:53.413399,3.0,advanced_calculations_v3,exp_v3_000712,2024.00,6.00,2.00,False,False,False,True,40
Ryan,2024-06-29,SavorOne,Uber,,21.07,21.07,,,,21.07,21.07,0.00,simple,False,,expense_history_csv,Consolidated_Expense_History_20250622.csv,2025-07-18T12:32:53.413399,3.0,advanced_calculations_v3,exp_v3_000713,2024.00,6.00,2.00,False,False,False,True,40
Ryan,2024-03-21,CreditOne x6396,Fry's,,23.36,23.36,Wine,,,23.36,23.36,0.00,simple,False,,expense_history_csv,Consolidated_Expense_History_20250622.csv,2025-07-18T12:32:53.413399,3.0,advanced_calculations_v3,exp_v3_000714,2024.00,3.00,1.00,False,False,False,True,60
Ryan,2024-03-22,CreditOne x6396,Fry's,,12.75,12.75,Wine,,,12.75,12.75,0.00,simple,False,,expense_history_csv,Consolidated_Expense_History_20250622.csv,2025-07-18T12:32:53.413399,3.0,advanced_calculations_v3,exp_v3_000715,2024.00,3.00,1.00,False,False,False,True,60
Ryan,2024-03-24,CreditOne x6396,Fry's,,31.99,31.99,"Titos, Yogurt",,,31.99,31.99,0.00,simple,False,,expense_history_csv,Consolidated_Expense_History_20250622.csv,2025-07-18T12:32:53.413399,3.0,advanced_calculations_v3,exp_v3_000716,2024.00,3.00,1.00,False,False,False,True,60
Ryan,2024-03-24,CreditOne x6396,Fry's,,33.98,33.98,Wine,,,33.98,33.98,0.00,simple,False,,expense_history_csv,Consolidated_Expense_History_20250622.csv,2025-07-18T12:32:53.413399,3.0,advanced_calculations_v3,exp_v3_000717,2024.00,3.00,1.00,False,False,False,True,60
Ryan,2024-03-26,CreditOne x6396,Fry's,,25.49,25.49,Wine,,,25.49,25.49,0.00,simple,False,,expense_history_csv,Consolidated_Expense_History_20250622.csv,2025-07-18T12:32:53.413399,3.0,advanced_calculations_v3,exp_v3_000718,2024.00,3.00,1.00,False,False,False,True,60
Ryan,2024-03-27,CreditOne x6396,Fry's,,9.12,9.12,Baked Chicken,,,9.12,9.12,0.00,simple,False,,expense_history_csv,Consolidated_Expense_History_20250622.csv,2025-07-18T12:32:53.413399,3.0,advanced_calculations_v3,exp_v3_000719,2024.00,3.00,1.00,False,False,False,True,60
Ryan,2024-03-27,CreditOne x6396,Fry's,,26.80,26.80,"Distilled Water, Wine",,,26.80,26.80,0.00,simple,False,,expense_history_csv,Consolidated_Expense_History_20250622.csv,2025-07-18T12:32:53.413399,3.0,advanced_calculations_v3,exp_v3_000720,2024.00,3.00,1.00,False,False,False,True,60
Ryan,2024-03-28,CreditOne x6396,Fry's,,27.62,27.62,Wine,,,27.62,27.62,0.00,simple,False,,expense_history_csv,Consolidated_Expense_History_20250622.csv,2025-07-18T12:32:53.413399,3.0,advanced_calculations_v3,exp_v3_000721,2024.00,3.00,1.00,False,False,False,True,60
Ryan,2024-03-31,CreditOne x6396,Fry's,,9.56,9.56,Wine,,,9.56,9.56,0.00,simple,False,,expense_history_csv,Consolidated_Expense_History_20250622.csv,2025-07-18T12:32:53.413399,3.0,advanced_calculations_v3,exp_v3_000722,2024.00,3.00,1.00,False,False,False,True,60
Ryan,2024-03-31,CreditOne x6396,Fry's,,37.00,37.00,"Pineapple, Wine",,,37.00,37.00,0.00,simple,False,,expense_history_csv,Consolidated_Expense_History_20250622.csv,2025-07-18T12:32:53.413399,3.0,advanced_calculations_v3,exp_v3_000723,2024.00,3.00,1.00,False,False,False,True,60
Ryan,2024-03-31,CreditOne x6396,Whole Foods,,28.55,28.55,Whole Foods,,,28.55,28.55,0.00,simple,False,,expense_history_csv,Consolidated_Expense_History_20250622.csv,2025-07-18T12:32:53.413399,3.0,advanced_calculations_v3,exp_v3_000724,2024.00,3.00,1.00,False,False,False,True,60
Ryan,2024-04-01,CreditOne x6396,Fry's,,33.79,33.79,"Wine, Butter, Yogurt",,,33.79,33.79,0.00,simple,False,,expense_history_csv,Consolidated_Expense_History_20250622.csv,2025-07-18T12:32:53.413399,3.0,advanced_calculations_v3,exp_v3_000725,2024.00,4.00,2.00,False,False,False,True,60
Ryan,2024-04-02,CreditOne x6396,Fry's,,40.79,40.79,"Pickles, Rotisserie Chicken, Wine",,,40.79,40.79,0.00,simple,False,,expense_history_csv,Consolidated_Expense_History_20250622.csv,2025-07-18T12:32:53.413399,3.0,advanced_calculations_v3,exp_v3_000726,2024.00,4.00,2.00,False,False,False,True,60
Ryan,2024-04-03,CreditOne x6396,Fry's,,33.55,33.55,"Power Mop Cleaner, Wine",,,33.55,33.55,0.00,simple,False,,expense_history_csv,Consolidated_Expense_History_20250622.csv,2025-07-18T12:32:53.413399,3.0,advanced_calculations_v3,exp_v3_000727,2024.00,4.00,2.00,False,False,False,True,60
Ryan,2024-04-04,CreditOne x6396,Fry's,,24.43,24.43,Wine,,,24.43,24.43,0.00,simple,False,,expense_history_csv,Consolidated_Expense_History_20250622.csv,2025-07-18T12:32:53.413399,3.0,advanced_calculations_v3,exp_v3_000728,2024.00,4.00,2.00,False,False,False,True,60
Ryan,2024-04-05,CreditOne x6396,Fry's,,27.65,27.65,Wine,,,27.65,27.65,0.00,simple,False,,expense_history_csv,Consolidated_Expense_History_20250622.csv,2025-07-18T12:32:53.413399,3.0,advanced_calculations_v3,exp_v3_000729,2024.00,4.00,2.00,False,False,False,True,60
Ryan,2024-04-05,CreditOne x6396,FRYS-FOOD-DRG #051 CHANDLER AZ D [Fry's Food and Drug],,26.55,26.55,Wine,,,26.55,26.55,0.00,simple,False,,expense_history_csv,Consolidated_Expense_History_20250622.csv,2025-07-18T12:32:53.413399,3.0,advanced_calculations_v3,exp_v3_000730,2024.00,4.00,2.00,False,False,False,True,60
Ryan,2024-04-07,CreditOne x6396,Fry's,,26.55,26.55,Wine,,,26.55,26.55,0.00,simple,False,,expense_history_csv,Consolidated_Expense_History_20250622.csv,2025-07-18T12:32:53.413399,3.0,advanced_calculations_v3,exp_v3_000731,2024.00,4.00,2.00,False,False,False,True,60
Ryan,2024-04-07,CreditOne x6396,CULVERS OF CHANDLER CHANDLER AZ D [Culver's],,7.11,7.11,"Ice Cream (put twice, second one deleted)",,,7.11,7.11,1.00,simple,False,"Mathematical operation: (put twice, second one deleted)",expense_history_csv,Consolidated_Expense_History_20250622.csv,2025-07-18T12:32:53.413399,3.0,advanced_calculations_v3,exp_v3_000732,2024.00,4.00,2.00,False,False,False,True,60
Ryan,2024-04-07,CreditOne x6396,FRYS-FOOD-DRG #051 CHANDLER AZ D [Fry's Food and Drug],,36.46,25.00,"Chicken, Wine",,,36.46,25.00,0.00,simple,False,,expense_history_csv,Consolidated_Expense_History_20250622.csv,2025-07-18T12:32:53.413399,3.0,advanced_calculations_v3,exp_v3_000733,2024.00,4.00,2.00,False,False,False,True,60
Ryan,2024-04-08,CreditOne x6396,Fry's,,36.46,26.46,"Rotisserie Chicken, Wine",,,36.46,26.46,0.00,simple,False,,expense_history_csv,Consolidated_Expense_History_20250622.csv,2025-07-18T12:32:53.413399,3.0,advanced_calculations_v3,exp_v3_000734,2024.00,4.00,2.00,False,False,False,True,60
Ryan,2024-04-08,CreditOne x6396,Fry's,,27.62,27.62,Wine,,,27.62,27.62,0.00,simple,False,,expense_history_csv,Consolidated_Expense_History_20250622.csv,2025-07-18T12:32:53.413399,3.0,advanced_calculations_v3,exp_v3_000735,2024.00,4.00,2.00,False,False,False,True,60
Ryan,2024-04-09,CreditOne x6396,Fry's,,29.95,29.95,Wine,,,29.95,29.95,0.00,simple,False,,expense_history_csv,Consolidated_Expense_History_20250622.csv,2025-07-18T12:32:53.413399,3.0,advanced_calculations_v3,exp_v3_000736,2024.00,4.00,2.00,False,False,False,True,60
Ryan,2024-04-11,CreditOne x6396,Fry's,,15.08,15.08,Wine (1 Bottle),,,15.08,15.08,1.00,simple,False,Mathematical operation: (1 Bottle),expense_history_csv,Consolidated_Expense_History_20250622.csv,2025-07-18T12:32:53.413399,3.0,advanced_calculations_v3,exp_v3_000737,2024.00,4.00,2.00,False,False,False,True,60
Ryan,2024-04-12,CreditOne x6396,Fry's,,40.57,,why duplicated?,,,40.57,,0.00,simple,False,,expense_history_csv,Consolidated_Expense_History_20250622.csv,2025-07-18T12:32:53.413399,3.0,advanced_calculations_v3,exp_v3_000738,2024.00,4.00,2.00,False,False,False,True,40
Ryan,2024-04-12,CreditOne x6396,FRYS-FOOD-DRG #051 CHANDLER AZ D [Fry's Food and Drug],,40.57,,Wine,,,40.57,,0.00,simple,False,,expense_history_csv,Consolidated_Expense_History_20250622.csv,2025-07-18T12:32:53.413399,3.0,advanced_calculations_v3,exp_v3_000739,2024.00,4.00,2.00,False,False,False,True,40
Ryan,2024-04-13,CreditOne x6396,Fry's,,90.21,,"Wine, Flowers, Yougurt, Sushi - Adjust Accordingly",,,90.21,,0.00,simple,False,,expense_history_csv,Consolidated_Expense_History_20250622.csv,2025-07-18T12:32:53.413399,3.0,advanced_calculations_v3,exp_v3_000740,2024.00,4.00,2.00,False,False,False,True,40
Ryan,2024-04-14,CreditOne x6396,Fry's Food and Drug,,40.57,40.57,Wine,,,40.57,40.57,0.00,simple,False,,expense_history_csv,Consolidated_Expense_History_20250622.csv,2025-07-18T12:32:53.413399,3.0,advanced_calculations_v3,exp_v3_000741,2024.00,4.00,2.00,False,False,False,True,60
Ryan,2024-04-14,CreditOne x6396,Fry's Food and Drug,,90.21,,"Flowers, Oikos, Sushi, Wine (No Charge)",,,90.21,,1.00,simple,False,Mathematical operation: (No Charge),expense_history_csv,Consolidated_Expense_History_20250622.csv,2025-07-18T12:32:53.413399,3.0,advanced_calculations_v3,exp_v3_000742,2024.00,4.00,2.00,False,False,False,True,40
Ryan,2024-04-15,CreditOne x6396,Fry's,,38.96,38.96,Wine,,,38.96,38.96,0.00,simple,False,,expense_history_csv,Consolidated_Expense_History_20250622.csv,2025-07-18T12:32:53.413399,3.0,advanced_calculations_v3,exp_v3_000743,2024.00,4.00,2.00,False,False,False,True,60
Ryan,2024-04-15,CreditOne x6396,Fry's,,230.63,230.63,04/15 Groceries,,,230.63,230.63,1.00,simple,False,Mathematical operation: 04/15,expense_history_csv,Consolidated_Expense_History_20250622.csv,2025-07-18T12:32:53.413399,3.0,advanced_calculations_v3,exp_v3_000744,2024.00,4.00,2.00,False,False,False,True,60
Ryan,2024-04-16,CreditOne x6396,Fry's,,19.12,19.12,Wine,,,19.12,19.12,0.00,simple,False,,expense_history_csv,Consolidated_Expense_History_20250622.csv,2025-07-18T12:32:53.413399,3.0,advanced_calculations_v3,exp_v3_000745,2024.00,4.00,2.00,False,False,False,True,60
Ryan,2024-04-16,CreditOne x6396,Fry's Food and Drug,,38.96,25.00,"Chicken, Sop, Tooth Picks, White Claw",,,38.96,25.00,0.00,simple,False,,expense_history_csv,Consolidated_Expense_History_20250622.csv,2025-07-18T12:32:53.413399,3.0,advanced_calculations_v3,exp_v3_000746,2024.00,4.00,2.00,False,False,False,True,60
Ryan,2024-04-17,CreditOne x6396,FRYS 5051 [Frys],,230.63,230.63,Food+,,,230.63,230.63,0.00,simple,False,,expense_history_csv,Consolidated_Expense_History_20250622.csv,2025-07-18T12:32:53.413399,3.0,advanced_calculations_v3,exp_v3_000747,2024.00,4.00,2.00,False,False,False,True,60
Ryan,2024-04-17,CreditOne x6396,Fry's Food and Drug,,19.12,19.12,White Claw,,,19.12,19.12,0.00,simple,False,,expense_history_csv,Consolidated_Expense_History_20250622.csv,2025-07-18T12:32:53.413399,3.0,advanced_calculations_v3,exp_v3_000748,2024.00,4.00,2.00,False,False,False,True,60
Ryan,2024-04-20,CreditOne x6396,FRYS-FOOD-DRG #051 CHANDLER AZ D [Fry's Food and Drug],,59.70,59.70,"White Claw, Wine",,,59.70,59.70,0.00,simple,False,,expense_history_csv,Consolidated_Expense_History_20250622.csv,2025-07-18T12:32:53.413399,3.0,advanced_calculations_v3,exp_v3_000749,2024.00,4.00,2.00,False,False,False,True,60
Ryan,2024-04-21,CreditOne x6396,FRYS-FOOD-DRG #051 CHANDLER AZ D [Fry's Food and Drug],,56.26,56.26,"White Claw, Wine, Mustard, Italian Sausage",,,56.26,56.26,0.00,simple,False,,expense_history_csv,Consolidated_Expense_History_20250622.csv,2025-07-18T12:32:53.413399,3.0,advanced_calculations_v3,exp_v3_000750,2024.00,4.00,2.00,False,False,False,True,60
Ryan,2024-04-28,CreditOne x6396,FRYS-FOOD-DRG #051 CHANDLER AZ D [Fry's Food and Drug],,87.89,87.89,"Chicken, Asaparagus, Frozen Vegetables, Wine",,,87.89,87.89,0.00,simple,False,,expense_history_csv,Consolidated_Expense_History_20250622.csv,2025-07-18T12:32:53.413399,3.0,advanced_calculations_v3,exp_v3_000751,2024.00,4.00,2.00,False,False,False,True,60
Ryan,2024-04-29,CreditOne x6396,FRYS-FOOD-DRG #051 CHANDLER AZ D [Fry's Food and Drug],,28.17,28.17,"Romaine Lettuce, Carrots, Wine",,,28.17,28.17,0.00,simple,False,,expense_history_csv,Consolidated_Expense_History_20250622.csv,2025-07-18T12:32:53.413399,3.0,advanced_calculations_v3,exp_v3_000752,2024.00,4.00,2.00,False,False,False,True,60
Ryan,2024-04-30,CreditOne x6396,FRYS-FOOD-DRG #051 CHANDLER AZ D [Fry's Food and Drug],,44.15,34.15,"Chicken, Pickles, BBQ, Wine",,,44.15,34.15,0.00,simple,False,,expense_history_csv,Consolidated_Expense_History_20250622.csv,2025-07-18T12:32:53.413399,3.0,advanced_calculations_v3,exp_v3_000753,2024.00,4.00,2.00,False,False,False,True,60
Ryan,2024-05-23,CreditOne x6396,Fry's Food and Drug,,61.02,51.02,"Chicken, Granola, Wine",,,61.02,51.02,0.00,simple,False,,expense_history_csv,Consolidated_Expense_History_20250622.csv,2025-07-18T12:32:53.413399,3.0,advanced_calculations_v3,exp_v3_000754,2024.00,5.00,2.00,False,False,False,True,60
Ryan,2024-05-24,CreditOne x6396,Fry's Food and Drug,,38.69,38.69,"Distilled Water, Wine",,,38.69,38.69,0.00,simple,False,,expense_history_csv,Consolidated_Expense_History_20250622.csv,2025-07-18T12:32:53.413399,3.0,advanced_calculations_v3,exp_v3_000755,2024.00,5.00,2.00,False,False,False,True,60
Ryan,2024-05-26,CreditOne x6396,Fry's Food and Drug,,40.57,40.57,Wine,,,40.57,40.57,0.00,simple,False,,expense_history_csv,Consolidated_Expense_History_20250622.csv,2025-07-18T12:32:53.413399,3.0,advanced_calculations_v3,exp_v3_000756,2024.00,5.00,2.00,False,False,False,True,60
Ryan,2024-05-26,CreditOne x6396,Whole Foods,,52.07,52.07,Wine & Food,,,52.07,52.07,0.00,simple,False,,expense_history_csv,Consolidated_Expense_History_20250622.csv,2025-07-18T12:32:53.413399,3.0,advanced_calculations_v3,exp_v3_000757,2024.00,5.00,2.00,False,False,False,True,60
Ryan,2024-05-29,CreditOne x6396,Fry's Food and Drug,,70.44,70.44,"Bannas, Astroglide, Wine, White Claw",,,70.44,70.44,0.00,simple,False,,expense_history_csv,Consolidated_Expense_History_20250622.csv,2025-07-18T12:32:53.413399,3.0,advanced_calculations_v3,exp_v3_000758,2024.00,5.00,2.00,False,False,False,True,60
Ryan,2024-05-30,CreditOne x6396,Fry's Food and Drug,,52.07,52.07,"White Claw, Titos",,,52.07,52.07,0.00,simple,False,,expense_history_csv,Consolidated_Expense_History_20250622.csv,2025-07-18T12:32:53.413399,3.0,advanced_calculations_v3,exp_v3_000759,2024.00,5.00,2.00,False,False,False,True,60
Ryan,2024-05-31,CreditOne x6396,Fry's Food and Drug,,29.33,20.33,"Haribos, Albanese, Wine",,,29.33,20.33,0.00,simple,False,,expense_history_csv,Consolidated_Expense_History_20250622.csv,2025-07-18T12:32:53.413399,3.0,advanced_calculations_v3,exp_v3_000760,2024.00,5.00,2.00,False,False,False,True,60
Ryan,2024-06-02,CreditOne x6396,Fry's Food and Drug,,17.24,17.24,Cutwater,,,17.24,17.24,0.00,simple,False,,expense_history_csv,Consolidated_Expense_History_20250622.csv,2025-07-18T12:32:53.413399,3.0,advanced_calculations_v3,exp_v3_000761,2024.00,6.00,2.00,False,False,False,True,60
Ryan,2024-06-02,CreditOne x6396,Whole Foods,,8.11,,Fun Celebration Night For Jordyn Completing 1 Year and Summer Vacation (Free!),,,8.11,,1.00,simple,False,Mathematical operation: (Free!),expense_history_csv,Consolidated_Expense_History_20250622.csv,2025-07-18T12:32:53.413399,3.0,advanced_calculations_v3,exp_v3_000762,2024.00,6.00,2.00,False,False,False,True,40
Ryan,2024-06-02,CreditOne x6396,Whole Foods,,94.57,,Fun Celebration Night For Jordyn Completing 1 Year and Summer Vacation (Free!),,,94.57,,1.00,simple,False,Mathematical operation: (Free!),expense_history_csv,Consolidated_Expense_History_20250622.csv,2025-07-18T12:32:53.413399,3.0,advanced_calculations_v3,exp_v3_000763,2024.00,6.00,2.00,False,False,False,True,40
Ryan,2024-06-04,CreditOne x6396,Fry's Food and Drug,,54.58,54.58,"Wine, White Claw",,,54.58,54.58,0.00,simple,False,,expense_history_csv,Consolidated_Expense_History_20250622.csv,2025-07-18T12:32:53.413399,3.0,advanced_calculations_v3,exp_v3_000764,2024.00,6.00,2.00,False,False,False,True,60
Ryan,2024-06-05,CreditOne x6396,Fry's Food and Drug,,22.41,22.41,"Luna Bars, Pickles",,,22.41,22.41,0.00,simple,False,,expense_history_csv,Consolidated_Expense_History_20250622.csv,2025-07-18T12:32:53.413399,3.0,advanced_calculations_v3,exp_v3_000765,2024.00,6.00,2.00,False,False,False,True,60
Ryan,2024-06-06,CreditOne x6396,Fry's Food and Drug,,19.12,19.12,White Claw,,,19.12,19.12,0.00,simple,False,,expense_history_csv,Consolidated_Expense_History_20250622.csv,2025-07-18T12:32:53.413399,3.0,advanced_calculations_v3,exp_v3_000766,2024.00,6.00,2.00,False,False,False,True,60
Ryan,2024-06-07,CreditOne x6396,Fry's Food and Drug,,40.22,15.00,"White Claw, Pickles, Crest 3D Toothpaste",,,40.22,15.00,0.00,simple,False,,expense_history_csv,Consolidated_Expense_History_20250622.csv,2025-07-18T12:32:53.413399,3.0,advanced_calculations_v3,exp_v3_000767,2024.00,6.00,2.00,False,False,False,True,60
Ryan,2024-06-09,CreditOne x6396,Fry's Food and Drug,,42.49,42.42,"Cutwater, White Claw",,,42.49,42.42,0.00,simple,False,,expense_history_csv,Consolidated_Expense_History_20250622.csv,2025-07-18T12:32:53.413399,3.0,advanced_calculations_v3,exp_v3_000768,2024.00,6.00,2.00,False,False,False,True,60
Ryan,2024-06-09,CreditOne x6396,Fry's Food and Drug,,43.55,43.55,"Cider, Top Chico, Wine",,,43.55,43.55,0.00,simple,False,,expense_history_csv,Consolidated_Expense_History_20250622.csv,2025-07-18T12:32:53.413399,3.0,advanced_calculations_v3,exp_v3_000769,2024.00,6.00,2.00,False,False,False,True,60
Ryan,2024-06-12,CreditOne x6396,Fry's Food and Drug,,35.74,25.74,"Chicken, Chips, Green Pepper, White Claw",,,35.74,25.74,0.00,simple,False,,expense_history_csv,Consolidated_Expense_History_20250622.csv,2025-07-18T12:32:53.413399,3.0,advanced_calculations_v3,exp_v3_000770,2024.00,6.00,2.00,False,False,False,True,60
Ryan,2024-06-13,CreditOne x6396,Fry's Food and Drug,,35.39,35.39,"Luna Bars, Pickles, White Claw",,,35.39,35.39,0.00,simple,False,,expense_history_csv,Consolidated_Expense_History_20250622.csv,2025-07-18T12:32:53.413399,3.0,advanced_calculations_v3,exp_v3_000771,2024.00,6.00,2.00,False,False,False,True,60
Ryan,2024-06-14,CreditOne x6396,Fry's Food and Drug,,21.09,21.09,"Romaine Lettuce, White Claw",,,21.09,21.09,0.00,simple,False,,expense_history_csv,Consolidated_Expense_History_20250622.csv,2025-07-18T12:32:53.413399,3.0,advanced_calculations_v3,exp_v3_000772,2024.00,6.00,2.00,False,False,False,True,60
Ryan,2024-06-16,CreditOne x6396,Fry's Food and Drug,,18.06,18.06,White Claw,,,18.06,18.06,0.00,simple,False,,expense_history_csv,Consolidated_Expense_History_20250622.csv,2025-07-18T12:32:53.413399,3.0,advanced_calculations_v3,exp_v3_000773,2024.00,6.00,2.00,False,False,False,True,60
Ryan,2024-06-16,CreditOne x6396,Whole Foods,,19.39,19.39,Wine,,,19.39,19.39,0.00,simple,False,,expense_history_csv,Consolidated_Expense_History_20250622.csv,2025-07-18T12:32:53.413399,3.0,advanced_calculations_v3,exp_v3_000774,2024.00,6.00,2.00,False,False,False,True,60
Ryan,2024-06-23,Visa,Fry's Food and Drug,,41.98,41.98,Wine / Food,,,41.98,41.98,0.00,simple,False,,expense_history_csv,Consolidated_Expense_History_20250622.csv,2025-07-18T12:32:53.413399,3.0,advanced_calculations_v3,exp_v3_000775,2024.00,6.00,2.00,False,False,False,True,60
Ryan,2024-06-24,Visa,Fry's Food and Drug,,29.93,29.93,Wine / Food,,,29.93,29.93,0.00,simple,False,,expense_history_csv,Consolidated_Expense_History_20250622.csv,2025-07-18T12:32:53.413399,3.0,advanced_calculations_v3,exp_v3_000776,2024.00,6.00,2.00,False,False,False,True,60
Ryan,2024-06-25,Visa,Fry's Food and Drug,,48.22,48.22,Wine / Food,,,48.22,48.22,0.00,simple,False,,expense_history_csv,Consolidated_Expense_History_20250622.csv,2025-07-18T12:32:53.413399,3.0,advanced_calculations_v3,exp_v3_000777,2024.00,6.00,2.00,False,False,False,True,60
Ryan,2024-06-26,Visa,Fry's Food and Drug,,38.33,38.33,Wine / Food,,,38.33,38.33,0.00,simple,False,,expense_history_csv,Consolidated_Expense_History_20250622.csv,2025-07-18T12:32:53.413399,3.0,advanced_calculations_v3,exp_v3_000778,2024.00,6.00,2.00,False,False,False,True,60
Ryan,2024-06-30,Visa,Fry's Food and Drug,,92.25,92.25,Wine / Food,,,92.25,92.25,0.00,simple,False,,expense_history_csv,Consolidated_Expense_History_20250622.csv,2025-07-18T12:32:53.413399,3.0,advanced_calculations_v3,exp_v3_000779,2024.00,6.00,2.00,False,False,False,True,60
Ryan,2024-07-02,Visa,Whole Foods,,32.51,32.51,Wine / Food,,,32.51,32.51,0.00,simple,False,,expense_history_csv,Consolidated_Expense_History_20250622.csv,2025-07-18T12:32:53.413399,3.0,advanced_calculations_v3,exp_v3_000780,2024.00,7.00,3.00,False,False,False,True,60
Ryan,2024-03-18,Walmart Rewards Card,Walmart,,13.99,13.99,Walmart+,,,13.99,13.99,0.00,simple,False,,expense_history_csv,Consolidated_Expense_History_20250622.csv,2025-07-18T12:32:53.413399,3.0,advanced_calculations_v3,exp_v3_000781,2024.00,3.00,1.00,False,False,False,True,60
Ryan,2024-03-03,Wells Fargo Autograph,The Hub,,25.50,25.50,Dinner,,,25.50,25.50,0.00,simple,False,,expense_history_csv,Consolidated_Expense_History_20250622.csv,2025-07-18T12:32:53.413399,3.0,advanced_calculations_v3,exp_v3_000782,2024.00,3.00,1.00,False,False,False,True,60
Ryan,2024-03-03,Wells Fargo Autograph,The Hub,,51.31,51.31,Dinner,,,51.31,51.31,0.00,simple,False,,expense_history_csv,Consolidated_Expense_History_20250622.csv,2025-07-18T12:32:53.413399,3.0,advanced_calculations_v3,exp_v3_000783,2024.00,3.00,1.00,False,False,False,True,60
Ryan,2024-03-09,Wells Fargo Autograph,Stadium Club,,16.59,16.59,Beverages,,,16.59,16.59,0.00,simple,False,,expense_history_csv,Consolidated_Expense_History_20250622.csv,2025-07-18T12:32:53.413399,3.0,advanced_calculations_v3,exp_v3_000784,2024.00,3.00,1.00,False,False,False,True,60
Ryan,2024-03-09,Wells Fargo Autograph,Culver's,,11.33,11.33,Ice Cream,,,11.33,11.33,0.00,simple,False,,expense_history_csv,Consolidated_Expense_History_20250622.csv,2025-07-18T12:32:53.413399,3.0,advanced_calculations_v3,exp_v3_000785,2024.00,3.00,1.00,False,False,False,True,60
Ryan,2024-03-09,Wells Fargo Autograph,Snooze,,66.47,66.47,Snooze,,,66.47,66.47,0.00,simple,False,,expense_history_csv,Consolidated_Expense_History_20250622.csv,2025-07-18T12:32:53.413399,3.0,advanced_calculations_v3,exp_v3_000786,2024.00,3.00,1.00,False,False,False,True,60
Ryan,2024-03-10,Wells Fargo Autograph,Foundation,,35.00,35.00,Foundation Downtown Tempe,,,35.00,35.00,0.00,simple,False,,expense_history_csv,Consolidated_Expense_History_20250622.csv,2025-07-18T12:32:53.413399,3.0,advanced_calculations_v3,exp_v3_000787,2024.00,3.00,1.00,False,False,False,True,60
Ryan,2024-03-10,Wells Fargo Autograph,Foor 4 Your Skin,,36.22,36.22,Art Festival,,,36.22,36.22,0.00,simple,False,,expense_history_csv,Consolidated_Expense_History_20250622.csv,2025-07-18T12:32:53.413399,3.0,advanced_calculations_v3,exp_v3_000788,2024.00,3.00,1.00,False,False,False,True,60
Ryan,2024-03-10,Wells Fargo Autograph,Page Springs Cellars,,19.46,19.46,Art Fesitval,,,19.46,19.46,0.00,simple,False,,expense_history_csv,Consolidated_Expense_History_20250622.csv,2025-07-18T12:32:53.413399,3.0,advanced_calculations_v3,exp_v3_000789,2024.00,3.00,1.00,False,False,False,True,60
Ryan,2024-03-10,Wells Fargo Autograph,Parking,,10.00,10.00,Art Festival,,,10.00,10.00,0.00,simple,False,,expense_history_csv,Consolidated_Expense_History_20250622.csv,2025-07-18T12:32:53.413399,3.0,advanced_calculations_v3,exp_v3_000790,2024.00,3.00,1.00,False,False,False,True,60
Ryan,2024-03-12,Wells Fargo Autograph,Little Szechuan,,12.81,12.81,Food,,,12.81,12.81,0.00,simple,False,,expense_history_csv,Consolidated_Expense_History_20250622.csv,2025-07-18T12:32:53.413399,3.0,advanced_calculations_v3,exp_v3_000791,2024.00,3.00,1.00,False,False,False,True,60
Ryan,2024-03-12,Wells Fargo Autograph,Little Szechuan,,35.40,35.40,Food,,,35.40,35.40,0.00,simple,False,,expense_history_csv,Consolidated_Expense_History_20250622.csv,2025-07-18T12:32:53.413399,3.0,advanced_calculations_v3,exp_v3_000792,2024.00,3.00,1.00,False,False,False,True,60
Ryan,2024-03-15,Wells Fargo Autograph,Cooper's Hawk,,54.44,54.44,Dinner,,,54.44,54.44,0.00,simple,False,,expense_history_csv,Consolidated_Expense_History_20250622.csv,2025-07-18T12:32:53.413399,3.0,advanced_calculations_v3,exp_v3_000793,2024.00,3.00,1.00,False,False,False,True,60
Ryan,2024-03-16,Wells Fargo Autograph,Butler Amusements Inc.,,20.00,20.00,BUTLER AMUSEMENTS INC,,,20.00,20.00,0.00,simple,False,,expense_history_csv,Consolidated_Expense_History_20250622.csv,2025-07-18T12:32:53.413399,3.0,advanced_calculations_v3,exp_v3_000794,2024.00,3.00,1.00,False,False,False,True,60
Ryan,2024-03-16,Wells Fargo Autograph,Hill House,,9.00,9.00,HILL HOUSE ENTERPRISEPEORIA [Hill House Enterprise],,,9.00,9.00,0.00,simple,False,,expense_history_csv,Consolidated_Expense_History_20250622.csv,2025-07-18T12:32:53.413399,3.0,advanced_calculations_v3,exp_v3_000795,2024.00,3.00,1.00,False,False,False,True,60
Ryan,2024-03-16,Wells Fargo Autograph,Ostrich Festival,,13.48,,Ostrich Festival,,,13.48,,0.00,simple,False,,expense_history_csv,Consolidated_Expense_History_20250622.csv,2025-07-18T12:32:53.413399,3.0,advanced_calculations_v3,exp_v3_000796,2024.00,3.00,1.00,False,False,False,True,40
Ryan,2024-03-16,Wells Fargo Autograph,Ostrich Festival,,18.00,18.00,Ostrich Festival,,,18.00,18.00,0.00,simple,False,,expense_history_csv,Consolidated_Expense_History_20250622.csv,2025-07-18T12:32:53.413399,3.0,advanced_calculations_v3,exp_v3_000797,2024.00,3.00,1.00,False,False,False,True,60
Ryan,2024-03-16,Wells Fargo Autograph,Ostrich Festival,,84.00,84.00,Ostrich Festival,,,84.00,84.00,0.00,simple,False,,expense_history_csv,Consolidated_Expense_History_20250622.csv,2025-07-18T12:32:53.413399,3.0,advanced_calculations_v3,exp_v3_000798,2024.00,3.00,1.00,False,False,False,True,60
Ryan,2024-03-16,Wells Fargo Autograph,Steven Levine Entertainment,,15.00,15.00,STEVE LEVINE ENTERTAINMENSCOTTSDALE [Steve Levine Entertainmens],,,15.00,15.00,0.00,simple,False,,expense_history_csv,Consolidated_Expense_History_20250622.csv,2025-07-18T12:32:53.413399,3.0,advanced_calculations_v3,exp_v3_000799,2024.00,3.00,1.00,False,False,False,True,60
Ryan,2024-03-16,Wells Fargo Autograph,Hash Kitchen,,22.46,,TST* HASH KITCHEN - CHANDCHANDLER [Hash Kitchen Chandler] Only you drank,,,22.46,,0.00,simple,False,,expense_history_csv,Consolidated_Expense_History_20250622.csv,2025-07-18T12:32:53.413399,3.0,advanced_calculations_v3,exp_v3_000800,2024.00,3.00,1.00,False,False,False,True,40
Ryan,2024-03-16,Wells Fargo Autograph,Walgreen's,,7.28,7.28,Walgreens,,,7.28,7.28,0.00,simple,False,,expense_history_csv,Consolidated_Expense_History_20250622.csv,2025-07-18T12:32:53.413399,3.0,advanced_calculations_v3,exp_v3_000801,2024.00,3.00,1.00,False,False,False,True,60
Ryan,2024-03-17,Wells Fargo Autograph,Hilton,,61.08,61.08,Hilton [Hilton Chandler Fb],,,61.08,61.08,0.00,simple,False,,expense_history_csv,Consolidated_Expense_History_20250622.csv,2025-07-18T12:32:53.413399,3.0,advanced_calculations_v3,exp_v3_000802,2024.00,3.00,1.00,False,False,False,True,60
Ryan,2024-03-17,Wells Fargo Autograph,Hilton,,331.07,331.07,Hilton [Hilton Hotels & Resorts],,,331.07,331.07,0.00,simple,False,,expense_history_csv,Consolidated_Expense_History_20250622.csv,2025-07-18T12:32:53.413399,3.0,advanced_calculations_v3,exp_v3_000803,2024.00,3.00,1.00,False,False,False,True,60
Ryan,2024-03-17,Wells Fargo Autograph,Ostrich Festival,,9.00,9.00,Ostrich Festival,,,9.00,9.00,0.00,simple,False,,expense_history_csv,Consolidated_Expense_History_20250622.csv,2025-07-18T12:32:53.413399,3.0,advanced_calculations_v3,exp_v3_000804,2024.00,3.00,1.00,False,False,False,True,60
Ryan,2024-03-17,Wells Fargo Autograph,Ostrich Festival,,9.00,9.00,Ostrich Festival,,,9.00,9.00,0.00,simple,False,,expense_history_csv,Consolidated_Expense_History_20250622.csv,2025-07-18T12:32:53.413399,3.0,advanced_calculations_v3,exp_v3_000805,2024.00,3.00,1.00,False,False,False,True,60
Ryan,2024-03-17,Wells Fargo Autograph,Ostrich Festival,,26.52,26.52,Ostrich Festival,,,26.52,26.52,0.00,simple,False,,expense_history_csv,Consolidated_Expense_History_20250622.csv,2025-07-18T12:32:53.413399,3.0,advanced_calculations_v3,exp_v3_000806,2024.00,3.00,1.00,False,False,False,True,60
Ryan,2024-03-17,Wells Fargo Autograph,Ostrich Festival,,38.00,38.00,Ostrich Festival,,,38.00,38.00,0.00,simple,False,,expense_history_csv,Consolidated_Expense_History_20250622.csv,2025-07-18T12:32:53.413399,3.0,advanced_calculations_v3,exp_v3_000807,2024.00,3.00,1.00,False,False,False,True,60
Ryan,2024-03-17,Wells Fargo Autograph,Ostrich Festival,,40.96,40.96,Ostrich Festival,,,40.96,40.96,0.00,simple,False,,expense_history_csv,Consolidated_Expense_History_20250622.csv,2025-07-18T12:32:53.413399,3.0,advanced_calculations_v3,exp_v3_000808,2024.00,3.00,1.00,False,False,False,True,60
Ryan,2024-03-18,Wells Fargo Autograph,Fry's,,8.63,8.63,Fry's Food and Drug,,,8.63,8.63,0.00,simple,False,,expense_history_csv,Consolidated_Expense_History_20250622.csv,2025-07-18T12:32:53.413399,3.0,advanced_calculations_v3,exp_v3_000809,2024.00,3.00,1.00,False,False,False,True,60
Ryan,2024-03-23,Wells Fargo Autograph,Dave & Buster's,,48.65,48.65,Dave & Buster's,,,48.65,48.65,0.00,simple,False,,expense_history_csv,Consolidated_Expense_History_20250622.csv,2025-07-18T12:32:53.413399,3.0,advanced_calculations_v3,exp_v3_000810,2024.00,3.00,1.00,False,False,False,True,60
Ryan,2024-03-23,Wells Fargo Autograph,Pokitrition,,14.59,,TST* POKITRITION- CHANDLEChandler [Pokitrition Sushi Burritos & Poke] You ate alone,,,14.59,,0.00,simple,False,,expense_history_csv,Consolidated_Expense_History_20250622.csv,2025-07-18T12:32:53.413399,3.0,advanced_calculations_v3,exp_v3_000811,2024.00,3.00,1.00,False,False,False,True,40
Ryan,2024-03-24,Wells Fargo Autograph,Ulta,,4.30,4.30,Chap Stick,,,4.30,4.30,0.00,simple,False,,expense_history_csv,Consolidated_Expense_History_20250622.csv,2025-07-18T12:32:53.413399,3.0,advanced_calculations_v3,exp_v3_000812,2024.00,3.00,1.00,False,False,False,True,60
Ryan,2024-03-24,Wells Fargo Autograph,Whole Foods,,19.40,19.40,Wine,,,19.40,19.40,0.00,simple,False,,expense_history_csv,Consolidated_Expense_History_20250622.csv,2025-07-18T12:32:53.413399,3.0,advanced_calculations_v3,exp_v3_000813,2024.00,3.00,1.00,False,False,False,True,60
Ryan,2024-03-24,Wells Fargo Autograph,Zinburger Gilbert,,40.51,40.51,ZINBURGER GILBERT [Zinburger Wine & Burger Bar],,,40.51,40.51,0.00,simple,False,,expense_history_csv,Consolidated_Expense_History_20250622.csv,2025-07-18T12:32:53.413399,3.0,advanced_calculations_v3,exp_v3_000814,2024.00,3.00,1.00,False,False,False,True,60
Ryan,2024-03-25,Wells Fargo Autograph,Netflix,,24.78,24.78,Netflix,,,24.78,24.78,0.00,simple,False,,expense_history_csv,Consolidated_Expense_History_20250622.csv,2025-07-18T12:32:53.413399,3.0,advanced_calculations_v3,exp_v3_000815,2024.00,3.00,1.00,False,False,False,True,60
Ryan,2024-03-28,Wells Fargo Autograph,Blue Wasabi,,48.78,48.78,Dinner,,,48.78,48.78,0.00,simple,False,,expense_history_csv,Consolidated_Expense_History_20250622.csv,2025-07-18T12:32:53.413399,3.0,advanced_calculations_v3,exp_v3_000816,2024.00,3.00,1.00,False,False,False,True,60
Ryan,2024-03-29,Wells Fargo Autograph,AMF,,30.14,30.14,Bownling,,,30.14,30.14,0.00,simple,False,,expense_history_csv,Consolidated_Expense_History_20250622.csv,2025-07-18T12:32:53.413399,3.0,advanced_calculations_v3,exp_v3_000817,2024.00,3.00,1.00,False,False,False,True,60
Ryan,2024-03-29,Wells Fargo Autograph,Cobblestone,,22.00,,"Car Wash - your charge, not mine",,,22.00,,0.00,simple,False,,expense_history_csv,Consolidated_Expense_History_20250622.csv,2025-07-18T12:32:53.413399,3.0,advanced_calculations_v3,exp_v3_000818,2024.00,3.00,1.00,False,False,False,True,40
Ryan,2024-03-30,Wells Fargo Autograph,Harkin's,,28.00,28.00,Movie,,,28.00,28.00,0.00,simple,False,,expense_history_csv,Consolidated_Expense_History_20250622.csv,2025-07-18T12:32:53.413399,3.0,advanced_calculations_v3,exp_v3_000819,2024.00,3.00,1.00,False,False,False,True,60
Ryan,2024-03-30,Wells Fargo Autograph,Sprouts,,25.26,25.26,Food,,,25.26,25.26,0.00,simple,False,,expense_history_csv,Consolidated_Expense_History_20250622.csv,2025-07-18T12:32:53.413399,3.0,advanced_calculations_v3,exp_v3_000820,2024.00,3.00,1.00,False,False,False,True,60
Ryan,2024-03-30,Wells Fargo Autograph,Thirsty Lion,,41.11,41.11,Beverages,,,41.11,41.11,0.00,simple,False,,expense_history_csv,Consolidated_Expense_History_20250622.csv,2025-07-18T12:32:53.413399,3.0,advanced_calculations_v3,exp_v3_000821,2024.00,3.00,1.00,False,False,False,True,60
Ryan,2024-03-30,Wells Fargo Autograph,Whole Foods,,18.32,18.32,Wine,,,18.32,18.32,0.00,simple,False,,expense_history_csv,Consolidated_Expense_History_20250622.csv,2025-07-18T12:32:53.413399,3.0,advanced_calculations_v3,exp_v3_000822,2024.00,3.00,1.00,False,False,False,True,60
Ryan,2024-04-06,Wells Fargo Autograph,Chon Thai Food,,49.40,49.40,Dinner,,,49.40,49.40,0.00,simple,False,,expense_history_csv,Consolidated_Expense_History_20250622.csv,2025-07-18T12:32:53.413399,3.0,advanced_calculations_v3,exp_v3_000823,2024.00,4.00,2.00,False,False,False,True,60
Ryan,2024-04-06,Wells Fargo Autograph,La Ristra,,52.50,52.50,Dinner,,,52.50,52.50,0.00,simple,False,,expense_history_csv,Consolidated_Expense_History_20250622.csv,2025-07-18T12:32:53.413399,3.0,advanced_calculations_v3,exp_v3_000824,2024.00,4.00,2.00,False,False,False,True,60
Ryan,2024-04-06,Wells Fargo Autograph,The Hub,,39.89,39.89,Beverages or Dinner,,,39.89,39.89,0.00,simple,False,,expense_history_csv,Consolidated_Expense_History_20250622.csv,2025-07-18T12:32:53.413399,3.0,advanced_calculations_v3,exp_v3_000825,2024.00,4.00,2.00,False,False,False,True,60
Ryan,2024-04-06,Wells Fargo Autograph,West Alley BBQ Smokehouse,,44.88,44.88,Dinner,,,44.88,44.88,0.00,simple,False,,expense_history_csv,Consolidated_Expense_History_20250622.csv,2025-07-18T12:32:53.413399,3.0,advanced_calculations_v3,exp_v3_000826,2024.00,4.00,2.00,False,False,False,True,60
Ryan,2024-04-06,Wells Fargo Autograph,Whole Foods,,60.02,60.02,Wine  & ?,,,60.02,60.02,0.00,simple,False,,expense_history_csv,Consolidated_Expense_History_20250622.csv,2025-07-18T12:32:53.413399,3.0,advanced_calculations_v3,exp_v3_000827,2024.00,4.00,2.00,False,False,False,True,60
Ryan,2024-04-07,Wells Fargo Autograph,Black Sheep Wine Bar,,66.70,66.70,Beverages,,,66.70,66.70,0.00,simple,False,,expense_history_csv,Consolidated_Expense_History_20250622.csv,2025-07-18T12:32:53.413399,3.0,advanced_calculations_v3,exp_v3_000828,2024.00,4.00,2.00,False,False,False,True,60
Ryan,2024-04-12,Wells Fargo Autograph,Culver's,,25.90,25.90,Dinner,,,25.90,25.90,0.00,simple,False,,expense_history_csv,Consolidated_Expense_History_20250622.csv,2025-07-18T12:32:53.413399,3.0,advanced_calculations_v3,exp_v3_000829,2024.00,4.00,2.00,False,False,False,True,60
Ryan,2024-04-16,Wells Fargo Autograph,Amazon,,13.57,13.57,0.22um Filter,,,13.57,13.57,0.00,simple,False,,expense_history_csv,Consolidated_Expense_History_20250622.csv,2025-07-18T12:32:53.413399,3.0,advanced_calculations_v3,exp_v3_000830,2024.00,4.00,2.00,False,False,False,True,60
Ryan,2024-04-17,Wells Fargo Autograph,Amazon,,184.91,142.92,"Floor Lamp, 6 Pack Reusable Mop Pads, 20x 20ml Luer Locks, ZAMAT Pillow (Adjust Price $41.99)",,,184.91,142.92,1.00,simple,False,Mathematical operation: (Adjust Price $41.99),expense_history_csv,Consolidated_Expense_History_20250622.csv,2025-07-18T12:32:53.413399,3.0,advanced_calculations_v3,exp_v3_000831,2024.00,4.00,2.00,False,False,False,True,60
Ryan,2024-04-06,Wells Fargo Autograph,CHON THAI FOOD,,49.40,49.40,Dining Out,,,49.40,49.40,0.00,simple,False,,expense_history_csv,Consolidated_Expense_History_20250622.csv,2025-07-18T12:32:53.413399,3.0,advanced_calculations_v3,exp_v3_000832,2024.00,4.00,2.00,False,False,False,True,60
Ryan,2024-04-06,Wells Fargo Autograph,TST* LA RISTRA - CHANDLERChandler [La Ristra New Mexican Kitchen],,52.50,52.50,Dining Out,,,52.50,52.50,0.00,simple,False,,expense_history_csv,Consolidated_Expense_History_20250622.csv,2025-07-18T12:32:53.413399,3.0,advanced_calculations_v3,exp_v3_000833,2024.00,4.00,2.00,False,False,False,True,60
Ryan,2024-04-06,Wells Fargo Autograph,TST* THE HUB BAR & GRILL [The Hub Bar & Grill],,39.89,39.89,Dining Out,,,39.89,39.89,0.00,simple,False,,expense_history_csv,Consolidated_Expense_History_20250622.csv,2025-07-18T12:32:53.413399,3.0,advanced_calculations_v3,exp_v3_000834,2024.00,4.00,2.00,False,False,False,True,60
Ryan,2024-04-06,Wells Fargo Autograph,WEST ALLEY BBQ SMOKEHOU [West Alley BBQ and Smokehouse],,44.88,,Dining Out-- you ate alone,,,44.88,,0.00,simple,False,,expense_history_csv,Consolidated_Expense_History_20250622.csv,2025-07-18T12:32:53.413399,3.0,advanced_calculations_v3,exp_v3_000835,2024.00,4.00,2.00,False,False,False,True,40
Ryan,2024-04-06,Wells Fargo Autograph,Whole Foods,,60.02,60.02,Food,,,60.02,60.02,0.00,simple,False,,expense_history_csv,Consolidated_Expense_History_20250622.csv,2025-07-18T12:32:53.413399,3.0,advanced_calculations_v3,exp_v3_000836,2024.00,4.00,2.00,False,False,False,True,60
Ryan,2024-04-07,Wells Fargo Autograph,TST* BLACK SHEEP WINE BARChandler [BlackSheep Wine Bar & Merchant],,66.70,66.70,Dining Out,,,66.70,66.70,0.00,simple,False,,expense_history_csv,Consolidated_Expense_History_20250622.csv,2025-07-18T12:32:53.413399,3.0,advanced_calculations_v3,exp_v3_000837,2024.00,4.00,2.00,False,False,False,True,60
Ryan,2024-04-12,Wells Fargo Autograph,CULVERS OF CHANDLER [Culver's],,25.90,25.90,Dining Out,,,25.90,25.90,0.00,simple,False,,expense_history_csv,Consolidated_Expense_History_20250622.csv,2025-07-18T12:32:53.413399,3.0,advanced_calculations_v3,exp_v3_000838,2024.00,4.00,2.00,False,False,False,True,60
Ryan,2024-04-17,Wells Fargo Autograph,Amazon,,13.57,,,,,13.57,,0.00,simple,False,,expense_history_csv,Consolidated_Expense_History_20250622.csv,2025-07-18T12:32:53.413399,3.0,advanced_calculations_v3,exp_v3_000839,2024.00,4.00,2.00,False,False,False,True,20
Ryan,2024-04-18,Wells Fargo Autograph,Amazon,,184.91,,,,,184.91,,0.00,simple,False,,expense_history_csv,Consolidated_Expense_History_20250622.csv,2025-07-18T12:32:53.413399,3.0,advanced_calculations_v3,exp_v3_000840,2024.00,4.00,2.00,False,False,False,True,20
Ryan,2024-04-19,Wells Fargo Autograph,TST* PEDAL HAUS BREWERY [Pedal Haus Brewery],,31.49,31.49,Dining Out,,,31.49,31.49,0.00,simple,False,,expense_history_csv,Consolidated_Expense_History_20250622.csv,2025-07-18T12:32:53.413399,3.0,advanced_calculations_v3,exp_v3_000841,2024.00,4.00,2.00,False,False,False,True,60
Ryan,2024-04-20,Wells Fargo Autograph,81398 - 725 ASH AVENUE [Ash Avenue Comics & Books],,7.00,7.00,Dining Out,,,7.00,7.00,0.00,simple,False,,expense_history_csv,Consolidated_Expense_History_20250622.csv,2025-07-18T12:32:53.413399,3.0,advanced_calculations_v3,exp_v3_000842,2024.00,4.00,2.00,False,False,False,True,60
Ryan,2024-04-26,Wells Fargo Autograph,TST* THE HUB BAR & GRILL [The Hub Bar & Grill],,35.79,35.79,Dining Out,,,35.79,35.79,0.00,simple,False,,expense_history_csv,Consolidated_Expense_History_20250622.csv,2025-07-18T12:32:53.413399,3.0,advanced_calculations_v3,exp_v3_000843,2024.00,4.00,2.00,False,False,False,True,60
Ryan,2024-04-27,Wells Fargo Autograph,BLUE WASABI SUSHI & MARTIGILBERT [Blue Wasabi Sushi & Martini Bar],,89.99,89.99,-,,,89.99,89.99,0.00,simple,False,,expense_history_csv,Consolidated_Expense_History_20250622.csv,2025-07-18T12:32:53.413399,3.0,advanced_calculations_v3,exp_v3_000844,2024.00,4.00,2.00,False,False,False,True,60
Ryan,2024-04-28,Wells Fargo Autograph,ENDGAME BAR,,122.06,82.00,Dining Out,,,122.06,82.00,0.00,simple,False,,expense_history_csv,Consolidated_Expense_History_20250622.csv,2025-07-18T12:32:53.413399,3.0,advanced_calculations_v3,exp_v3_000845,2024.00,4.00,2.00,False,False,False,True,60
Ryan,2024-04-28,Wells Fargo Autograph,IN-N-OUT CHANDLER 2 [In-N-Out Burger],,5.78,5.78,Dining Out,,,5.78,5.78,0.00,simple,False,,expense_history_csv,Consolidated_Expense_History_20250622.csv,2025-07-18T12:32:53.413399,3.0,advanced_calculations_v3,exp_v3_000846,2024.00,4.00,2.00,False,False,False,True,60
Ryan,2024-04-30,Wells Fargo Autograph,YouTube TV g.co/helppay#CA [YouTube TV],,89.54,89.54,TV,,,89.54,89.54,0.00,simple,False,,expense_history_csv,Consolidated_Expense_History_20250622.csv,2025-07-18T12:32:53.413399,3.0,advanced_calculations_v3,exp_v3_000847,2024.00,4.00,2.00,False,False,False,True,60
Ryan,2024-05-01,Wells Fargo Autograph,Walgreens,,2.83,,Unknown,,,2.83,,0.00,simple,False,,expense_history_csv,Consolidated_Expense_History_20250622.csv,2025-07-18T12:32:53.413399,3.0,advanced_calculations_v3,exp_v3_000848,2024.00,5.00,2.00,False,False,False,True,40
Ryan,2024-05-04,Wells Fargo Autograph,CULVERS OF CHANDLER [Culver's],,15.44,15.44,Dining Out,,,15.44,15.44,0.00,simple,False,,expense_history_csv,Consolidated_Expense_History_20250622.csv,2025-07-18T12:32:53.413399,3.0,advanced_calculations_v3,exp_v3_000849,2024.00,5.00,2.00,False,False,False,True,60
Ryan,2024-05-09,Wells Fargo Autograph,CHEMLAB SUPPLY,,10.86,10.86,Misc,,,10.86,10.86,0.00,simple,False,,expense_history_csv,Consolidated_Expense_History_20250622.csv,2025-07-18T12:32:53.413399,3.0,advanced_calculations_v3,exp_v3_000850,2024.00,5.00,2.00,False,False,False,True,60
Ryan,2024-05-09,Wells Fargo Autograph,TST* O.H.S.O. - GILBERT [O.h.s.o.],,79.18,79.18,Dining Out,,,79.18,79.18,0.00,simple,False,,expense_history_csv,Consolidated_Expense_History_20250622.csv,2025-07-18T12:32:53.413399,3.0,advanced_calculations_v3,exp_v3_000851,2024.00,5.00,2.00,False,False,False,True,60
Ryan,2024-05-11,Wells Fargo Autograph,PHO CHANDLER,,46.28,46.28,Dining Out,,,46.28,46.28,0.00,simple,False,,expense_history_csv,Consolidated_Expense_History_20250622.csv,2025-07-18T12:32:53.413399,3.0,advanced_calculations_v3,exp_v3_000852,2024.00,5.00,2.00,False,False,False,True,60
Ryan,2024-05-11,Wells Fargo Autograph,TST* THE HUB BAR & GRILL [The Hub Bar & Grill],,36.50,36.50,Dining Out,,,36.50,36.50,0.00,simple,False,,expense_history_csv,Consolidated_Expense_History_20250622.csv,2025-07-18T12:32:53.413399,3.0,advanced_calculations_v3,exp_v3_000853,2024.00,5.00,2.00,False,False,False,True,60
Ryan,2024-05-12,Wells Fargo Autograph,FARM AND CRAFT SCOTTSDALESCOTTSDALE [Farm & Craft],,84.15,84.15,Dining Out,,,84.15,84.15,0.00,simple,False,,expense_history_csv,Consolidated_Expense_History_20250622.csv,2025-07-18T12:32:53.413399,3.0,advanced_calculations_v3,exp_v3_000854,2024.00,5.00,2.00,False,False,False,True,60
Ryan,2024-05-17,Wells Fargo Autograph,PICAZZOS HEALTHY ITALI [Picazzo's Healthy Italian Kitchen],,43.21,43.21,Dining Out,,,43.21,43.21,0.00,simple,False,,expense_history_csv,Consolidated_Expense_History_20250622.csv,2025-07-18T12:32:53.413399,3.0,advanced_calculations_v3,exp_v3_000855,2024.00,5.00,2.00,False,False,False,True,60
Ryan,2024-05-18,Wells Fargo Autograph,TST* THIRSTY LION GASTROPChandler [Thirsty Lion Gastropub & Grill],,71.69,71.69,Dining Out,,,71.69,71.69,0.00,simple,False,,expense_history_csv,Consolidated_Expense_History_20250622.csv,2025-07-18T12:32:53.413399,3.0,advanced_calculations_v3,exp_v3_000856,2024.00,5.00,2.00,False,False,False,True,60
Ryan,2024-05-19,Wells Fargo Autograph,CULVERS OF CHANDLER [Culver's],,24.17,24.17,Dining Out,,,24.17,24.17,0.00,simple,False,,expense_history_csv,Consolidated_Expense_History_20250622.csv,2025-07-18T12:32:53.413399,3.0,advanced_calculations_v3,exp_v3_000857,2024.00,5.00,2.00,False,False,False,True,60
Ryan,2024-05-19,Wells Fargo Autograph,TST* O.H.S.O. - GILBERT [O.h.s.o.],,33.03,33.03,Dining Out,,,33.03,33.03,0.00,simple,False,,expense_history_csv,Consolidated_Expense_History_20250622.csv,2025-07-18T12:32:53.413399,3.0,advanced_calculations_v3,exp_v3_000858,2024.00,5.00,2.00,False,False,False,True,60
Ryan,2024-05-26,Wells Fargo Autograph,Whole Foods,,55.63,55.63,Food,,,55.63,55.63,0.00,simple,False,,expense_history_csv,Consolidated_Expense_History_20250622.csv,2025-07-18T12:32:53.413399,3.0,advanced_calculations_v3,exp_v3_000859,2024.00,5.00,2.00,False,False,False,True,60
Ryan,2024-05-27,Wells Fargo Autograph,TST* THE HUB BAR & GRILL [The Hub Bar & Grill],,46.10,46.10,Dining Out,,,46.10,46.10,0.00,simple,False,,expense_history_csv,Consolidated_Expense_History_20250622.csv,2025-07-18T12:32:53.413399,3.0,advanced_calculations_v3,exp_v3_000860,2024.00,5.00,2.00,False,False,False,True,60
Ryan,2024-05-28,Wells Fargo Autograph,Netflix,,24.78,24.78,Entertainment,,,24.78,24.78,0.00,simple,False,,expense_history_csv,Consolidated_Expense_History_20250622.csv,2025-07-18T12:32:53.413399,3.0,advanced_calculations_v3,exp_v3_000861,2024.00,5.00,2.00,False,False,False,True,60
Ryan,2024-05-28,Wells Fargo Autograph,TACO`S CHIWAS [Tacos Chiwas],,2.70,2.70,Dining Out,,,2.70,2.70,0.00,simple,False,,expense_history_csv,Consolidated_Expense_History_20250622.csv,2025-07-18T12:32:53.413399,3.0,advanced_calculations_v3,exp_v3_000862,2024.00,5.00,2.00,False,False,False,True,60
Ryan,2024-05-31,Wells Fargo Autograph,SPINATOS PIZZA - SFR 05 [Spinatos Pizza],,85.13,85.13,Dining Out,,,85.13,85.13,0.00,simple,False,,expense_history_csv,Consolidated_Expense_History_20250622.csv,2025-07-18T12:32:53.413399,3.0,advanced_calculations_v3,exp_v3_000863,2024.00,5.00,2.00,False,False,False,True,60
Ryan,2024-06-01,Wells Fargo Autograph,IN-N-OUT CHANDLER 2 [In-N-Out Burger],,16.32,16.32,Dining Out,,,16.32,16.32,0.00,simple,False,,expense_history_csv,Consolidated_Expense_History_20250622.csv,2025-07-18T12:32:53.413399,3.0,advanced_calculations_v3,exp_v3_000864,2024.00,6.00,2.00,False,False,False,True,60
Ryan,2024-06-08,Wells Fargo Autograph,UNPHOGETTABLE CHANDLER [unPhogettable],,46.78,46.78,Dining Out,,,46.78,46.78,0.00,simple,False,,expense_history_csv,Consolidated_Expense_History_20250622.csv,2025-07-18T12:32:53.413399,3.0,advanced_calculations_v3,exp_v3_000865,2024.00,6.00,2.00,False,False,False,True,60
Ryan,2024-06-09,Wells Fargo Autograph,CLEAN FREAK - CHANDLER [Clean Freak],,22.00,22.00,Entertainment,,,22.00,22.00,0.00,simple,False,,expense_history_csv,Consolidated_Expense_History_20250622.csv,2025-07-18T12:32:53.413399,3.0,advanced_calculations_v3,exp_v3_000866,2024.00,6.00,2.00,False,False,False,True,60
Ryan,2024-06-09,Wells Fargo Autograph,HARKINS CHANDLER FASHON,,28.00,28.00,Entertainment,,,28.00,28.00,0.00,simple,False,,expense_history_csv,Consolidated_Expense_History_20250622.csv,2025-07-18T12:32:53.413399,3.0,advanced_calculations_v3,exp_v3_000867,2024.00,6.00,2.00,False,False,False,True,60
Ryan,2024-06-12,Wells Fargo Autograph,IN-N-OUT CHANDLER 2 [In-N-Out Burger],,18.65,18.65,Dining Out,,,18.65,18.65,0.00,simple,False,,expense_history_csv,Consolidated_Expense_History_20250622.csv,2025-07-18T12:32:53.413399,3.0,advanced_calculations_v3,exp_v3_000868,2024.00,6.00,2.00,False,False,False,True,60
Ryan,2024-06-14,Wells Fargo Autograph,STARLITE BBQ,,88.47,88.47,Dining Out,,,88.47,88.47,0.00,simple,False,,expense_history_csv,Consolidated_Expense_History_20250622.csv,2025-07-18T12:32:53.413399,3.0,advanced_calculations_v3,exp_v3_000869,2024.00,6.00,2.00,False,False,False,True,60
Ryan,2024-06-15,Wells Fargo Autograph,Whole Foods,,24.62,24.62,Food,,,24.62,24.62,0.00,simple,False,,expense_history_csv,Consolidated_Expense_History_20250622.csv,2025-07-18T12:32:53.413399,3.0,advanced_calculations_v3,exp_v3_000870,2024.00,6.00,2.00,False,False,False,True,60
Ryan,2024-06-16,Wells Fargo Autograph,Bourbon Jacks,,39.80,39.80,Dining Out,,,39.80,39.80,0.00,simple,False,,expense_history_csv,Consolidated_Expense_History_20250622.csv,2025-07-18T12:32:53.413399,3.0,advanced_calculations_v3,exp_v3_000871,2024.00,6.00,2.00,False,False,False,True,60
Ryan,2024-06-16,Wells Fargo Autograph,Drury Hotels,,27.02,27.02,Entertainment,,,27.02,27.02,0.00,simple,False,,expense_history_csv,Consolidated_Expense_History_20250622.csv,2025-07-18T12:32:53.413399,3.0,advanced_calculations_v3,exp_v3_000872,2024.00,6.00,2.00,False,False,False,True,60
Ryan,2024-06-16,Wells Fargo Autograph,Drury Hotels,,200.00,,Entertainment,,,200.00,,0.00,simple,False,,expense_history_csv,Consolidated_Expense_History_20250622.csv,2025-07-18T12:32:53.413399,3.0,advanced_calculations_v3,exp_v3_000873,2024.00,6.00,2.00,False,False,False,True,40
Ryan,2024-06-16,Wells Fargo Autograph,Whole Foods,,32.88,32.88,Food,,,32.88,32.88,0.00,simple,False,,expense_history_csv,Consolidated_Expense_History_20250622.csv,2025-07-18T12:32:53.413399,3.0,advanced_calculations_v3,exp_v3_000874,2024.00,6.00,2.00,False,False,False,True,60
Ryan,2024-06-16,Wells Fargo Autograph,Fry's Food and Drug,,144.17,144.17,Food,,,144.17,144.17,0.00,simple,False,,expense_history_csv,Consolidated_Expense_History_20250622.csv,2025-07-18T12:32:53.413399,3.0,advanced_calculations_v3,exp_v3_000875,2024.00,6.00,2.00,False,False,False,True,60
Ryan,2024-06-22,WELLS FARGO AUTOGRAPH VISA® CARD ...5037,GDP*Against the Grain gluMesa [Against The Grain Glumesa],,60.59,60.59,,,,60.59,60.59,0.00,simple,False,,expense_history_csv,Consolidated_Expense_History_20250622.csv,2025-07-18T12:32:53.413399,3.0,advanced_calculations_v3,exp_v3_000876,2024.00,6.00,2.00,False,False,False,True,40
Ryan,2024-06-22,WELLS FARGO AUTOGRAPH VISA® CARD ...5037,TST* THE BRASS TAPS - VERGILBERT [The Brass Tap],,21.70,21.70,,,,21.70,21.70,0.00,simple,False,,expense_history_csv,Consolidated_Expense_History_20250622.csv,2025-07-18T12:32:53.413399,3.0,advanced_calculations_v3,exp_v3_000877,2024.00,6.00,2.00,False,False,False,True,40
Ryan,2024-06-22,WELLS FARGO AUTOGRAPH VISA® CARD ...5037,TST* THE FORUM COMPLEX [The Forum Complex],,82.74,82.74,,,,82.74,82.74,0.00,simple,False,,expense_history_csv,Consolidated_Expense_History_20250622.csv,2025-07-18T12:32:53.413399,3.0,advanced_calculations_v3,exp_v3_000878,2024.00,6.00,2.00,False,False,False,True,40
Ryan,2024-06-23,WELLS FARGO AUTOGRAPH VISA® CARD ...5037,TST* O.H.S.O. - GILBERT [O.h.s.o.],,80.47,80.47,,,,80.47,80.47,0.00,simple,False,,expense_history_csv,Consolidated_Expense_History_20250622.csv,2025-07-18T12:32:53.413399,3.0,advanced_calculations_v3,exp_v3_000879,2024.00,6.00,2.00,False,False,False,True,40
Ryan,2024-06-27,WELLS FARGO AUTOGRAPH VISA® CARD ...5037,DRURY INNS [Drury Inn & Suites Phoenix Chandler Fashion Center],,133.99,133.99,,,,133.99,133.99,0.00,simple,False,,expense_history_csv,Consolidated_Expense_History_20250622.csv,2025-07-18T12:32:53.413399,3.0,advanced_calculations_v3,exp_v3_000880,2024.00,6.00,2.00,False,False,False,True,40
Ryan,2024-06-27,WELLS FARGO AUTOGRAPH VISA® CARD ...5037,Netflix,,24.78,24.78,,,,24.78,24.78,0.00,simple,False,,expense_history_csv,Consolidated_Expense_History_20250622.csv,2025-07-18T12:32:53.413399,3.0,advanced_calculations_v3,exp_v3_000881,2024.00,6.00,2.00,False,False,False,True,40
Ryan,2024-06-28,WELLS FARGO AUTOGRAPH VISA® CARD ...5037,CHON THAI FOOD,,49.40,49.40,,,,49.40,49.40,0.00,simple,False,,expense_history_csv,Consolidated_Expense_History_20250622.csv,2025-07-18T12:32:53.413399,3.0,advanced_calculations_v3,exp_v3_000882,2024.00,6.00,2.00,False,False,False,True,40
Ryan,2024-06-29,WELLS FARGO AUTOGRAPH VISA® CARD ...5037,ARIZONA POODLE RESCUEMaricopa [Arizona Poodle Rescue],,600.00,600.00,,,,600.00,600.00,0.00,simple,False,,expense_history_csv,Consolidated_Expense_History_20250622.csv,2025-07-18T12:32:53.413399,3.0,advanced_calculations_v3,exp_v3_000883,2024.00,6.00,2.00,False,False,False,True,40
Ryan,2024-06-29,WELLS FARGO AUTOGRAPH VISA® CARD ...5037,FARISH HOUSE [The Farish House],,128.83,128.83,,,,128.83,128.83,0.00,simple,False,,expense_history_csv,Consolidated_Expense_History_20250622.csv,2025-07-18T12:32:53.413399,3.0,advanced_calculations_v3,exp_v3_000884,2024.00,6.00,2.00,False,False,False,True,40
Ryan,2024-06-29,WELLS FARGO AUTOGRAPH VISA® CARD ...5037,HYATT REG PHOENIX F&B [Hyatt Resorts],,161.41,161.41,,,,161.41,161.41,0.00,simple,False,,expense_history_csv,Consolidated_Expense_History_20250622.csv,2025-07-18T12:32:53.413399,3.0,advanced_calculations_v3,exp_v3_000885,2024.00,6.00,2.00,False,False,False,True,40
Ryan,2024-06-29,WELLS FARGO AUTOGRAPH VISA® CARD ...5037,PetSmart,,23.88,23.88,,,,23.88,23.88,0.00,simple,False,,expense_history_csv,Consolidated_Expense_History_20250622.csv,2025-07-18T12:32:53.413399,3.0,advanced_calculations_v3,exp_v3_000886,2024.00,6.00,2.00,False,False,False,True,40
Ryan,2024-06-30,WELLS FARGO AUTOGRAPH VISA® CARD ...5037,CULVERS OF CHANDLER [Culver's],,27.41,27.41,,,,27.41,27.41,0.00,simple,False,,expense_history_csv,Consolidated_Expense_History_20250622.csv,2025-07-18T12:32:53.413399,3.0,advanced_calculations_v3,exp_v3_000887,2024.00,6.00,2.00,False,False,False,True,40
Ryan,2024-07-01,WELLS FARGO AUTOGRAPH VISA® CARD ...5037,TST* SNOOZE - AHWATUKEE [Snooze],,82.13,82.13,,,,82.13,82.13,0.00,simple,False,,expense_history_csv,Consolidated_Expense_History_20250622.csv,2025-07-18T12:32:53.413399,3.0,advanced_calculations_v3,exp_v3_000888,2024.00,7.00,3.00,False,False,False,True,40
Ryan,2024-07-01,WELLS FARGO AUTOGRAPH VISA® CARD ...5038,Whole Foods,,23.78,23.78,,,,23.78,23.78,0.00,simple,False,,expense_history_csv,Consolidated_Expense_History_20250622.csv,2025-07-18T12:32:53.413399,3.0,advanced_calculations_v3,exp_v3_000889,2024.00,7.00,3.00,False,False,False,True,40
Ryan,2024-07-01,WELLS FARGO AUTOGRAPH VISA® CARD ...5039,Sneaky Bird,,28.01,28.01,,,,28.01,28.01,0.00,simple,False,,expense_history_csv,Consolidated_Expense_History_20250622.csv,2025-07-18T12:32:53.413399,3.0,advanced_calculations_v3,exp_v3_000890,2024.00,7.00,3.00,False,False,False,True,40
Ryan,2024-07-02,WELLS FARGO AUTOGRAPH VISA® CARD ...5040,Whole Foods,,24.40,24.40,,,,24.40,24.40,0.00,simple,False,,expense_history_csv,Consolidated_Expense_History_20250622.csv,2025-07-18T12:32:53.413399,3.0,advanced_calculations_v3,exp_v3_000891,2024.00,7.00,3.00,False,False,False,True,40
Ryan,2024-07-02,WELLS FARGO AUTOGRAPH VISA® CARD ...5041,PetSmart,,2.15,2.15,,,,2.15,2.15,0.00,simple,False,,expense_history_csv,Consolidated_Expense_History_20250622.csv,2025-07-18T12:32:53.413399,3.0,advanced_calculations_v3,exp_v3_000892,2024.00,7.00,3.00,False,False,False,True,40
Ryan,2024-07-02,WELLS FARGO AUTOGRAPH VISA® CARD ...5042,Postinos,,41.84,41.84,,,,41.84,41.84,0.00,simple,False,,expense_history_csv,Consolidated_Expense_History_20250622.csv,2025-07-18T12:32:53.413399,3.0,advanced_calculations_v3,exp_v3_000893,2024.00,7.00,3.00,False,False,False,True,40
Ryan,2024-03-17,Mercury,Pearl,,60.00,60.00,Lawyer,,,60.00,60.00,0.00,simple,False,,expense_history_csv,Consolidated_Expense_History_20250622.csv,2025-07-18T12:32:53.413399,3.0,advanced_calculations_v3,exp_v3_000894,2024.00,3.00,1.00,False,False,False,True,60
Ryan,2024-03-22,Mercury,Amazon,,52.82,,Teeth Whitening,,,52.82,,0.00,simple,False,,expense_history_csv,Consolidated_Expense_History_20250622.csv,2025-07-18T12:32:53.413399,3.0,advanced_calculations_v3,exp_v3_000895,2024.00,3.00,1.00,False,False,False,True,40
Ryan,2024-03-23,Mercury,Playstation Nework,,43.11,43.11,PlayStation Subscription,,,43.11,43.11,0.00,simple,False,,expense_history_csv,Consolidated_Expense_History_20250622.csv,2025-07-18T12:32:53.413399,3.0,advanced_calculations_v3,exp_v3_000896,2024.00,3.00,1.00,False,False,False,True,60
Ryan,2024-03-25,Mercury,Amazon,,22.69,22.69,20x Amber Nasal Spray Bottle + 2 Funnels,,,22.69,22.69,0.00,simple,False,,expense_history_csv,Consolidated_Expense_History_20250622.csv,2025-07-18T12:32:53.413399,3.0,advanced_calculations_v3,exp_v3_000897,2024.00,3.00,1.00,False,False,False,True,60
Ryan,2024-03-29,Mercury,Harkin's,,29.50,29.50,Movie,,,29.50,29.50,0.00,simple,False,,expense_history_csv,Consolidated_Expense_History_20250622.csv,2025-07-18T12:32:53.413399,3.0,advanced_calculations_v3,exp_v3_000898,2024.00,3.00,1.00,False,False,False,True,60
Ryan,2024-04-06,Mercury,Amazon,,245.38,,Govee Table Lamp ($59.00) + 6 Pack Reusable Mops ($16.99),,,245.38,,2.00,simple,False,Mathematical operation: ($59.00); Mathematical operation: ($16.99),expense_history_csv,Consolidated_Expense_History_20250622.csv,2025-07-18T12:32:53.413399,3.0,advanced_calculations_v3,exp_v3_000899,2024.00,4.00,2.00,False,False,False,True,40
Ryan,2024-04-08,Mercury,Amazon,,25.57,25.57,Chomps (Jordyn - I'll pay 50%),,,25.57,25.57,1.00,simple,False,Mathematical operation: (Jordyn - I'll pay 50%),expense_history_csv,Consolidated_Expense_History_20250622.csv,2025-07-18T12:32:53.413399,3.0,advanced_calculations_v3,exp_v3_000900,2024.00,4.00,2.00,False,False,False,True,60
Ryan,2024-04-09,Mercury,Blizzard,,16.17,,World of Warcraft,,,16.17,,0.00,simple,False,,expense_history_csv,Consolidated_Expense_History_20250622.csv,2025-07-18T12:32:53.413399,3.0,advanced_calculations_v3,exp_v3_000901,2024.00,4.00,2.00,False,False,False,True,40
Ryan,2024-04-09,Mercury,Amazon,,74.99,,"DEVOPS 3 Pack Men's Athletic Compression Shirts Sleeveless (Medium, Black/Blue/White); DEVOPS 3 Pack Men's Compression Pants Athletic Leggings (Medium, Black/Black/Black);",,,74.99,,2.00,simple,False,"Mathematical operation: (Medium, Black/Blue/White); Mathematical operation: (Medium, Black/Black/Black)",expense_history_csv,Consolidated_Expense_History_20250622.csv,2025-07-18T12:32:53.413399,3.0,advanced_calculations_v3,exp_v3_000902,2024.00,4.00,2.00,False,False,False,True,40
Ryan,2024-04-10,Mercury,Amazon,,179.49,,"Homedics Tabletop Water Fountain, Home Décor Soothing Sound Machine - Automatic Pump, Deep Basin & Natural River Rocks. Indoor Zen Relaxation for Office, Living Room, or Bedroom, 8.25” Tall; Under Armour Men's ColdGear Armour Fitted Crew, Black (001)/White, Medium; Under Armour Men's ColdGear Armour Leggings, Black (001)/White, Medium; Under Armour Men's Armour HeatGear Compression Long-Sleeve T-Shirt , Black (001)/White , Medium; Under Armour Men's Armour HeatGear Compression Long-Sleeve T-Shirt , Black (001)/White , Small;",,,179.49,,4.00,complex,False,Mathematical operation: (001); Mathematical operation: (001); Mathematical operation: (001); Mathematical operation: (001),expense_history_csv,Consolidated_Expense_History_20250622.csv,2025-07-18T12:32:53.413399,3.0,advanced_calculations_v3,exp_v3_000903,2024.00,4.00,2.00,True,False,False,True,40
Ryan,2024-04-10,Mercury,Amazon,,38.00,,,,,38.00,,0.00,simple,False,,expense_history_csv,Consolidated_Expense_History_20250622.csv,2025-07-18T12:32:53.413399,3.0,advanced_calculations_v3,exp_v3_000904,2024.00,4.00,2.00,False,False,False,True,20
Ryan,2024-04-12,Mercury,Target,,4.30,4.30,Back to the Future;,,,4.30,4.30,0.00,simple,False,,expense_history_csv,Consolidated_Expense_History_20250622.csv,2025-07-18T12:32:53.413399,3.0,advanced_calculations_v3,exp_v3_000905,2024.00,4.00,2.00,False,False,False,True,60
Ryan,2024-04-12,Mercury,Amazon,,22.54,,"NOW Supplements, BioCell Collagen® Hydrolyzed Type II, Clinically Validated, 120 Veg Capsules; Nature's Bounty Calcium Carbonate & Vitamin D, Supports Immune Health & Bone Health, 1200mg Calcium & 1000IU Vitamin D3, 120 Softgels;",,,22.54,,0.00,simple,False,,expense_history_csv,Consolidated_Expense_History_20250622.csv,2025-07-18T12:32:53.413399,3.0,advanced_calculations_v3,exp_v3_000906,2024.00,4.00,2.00,False,False,False,True,40
Ryan,2024-04-12,Mercury,Amazon,,14.57,,"NOW Supplements, BioCell Collagen® Hydrolyzed Type II, Clinically Validated, 120 Veg Capsules; Nature's Bounty Calcium Carbonate & Vitamin D, Supports Immune Health & Bone Health, 1200mg Calcium & 1000IU Vitamin D3, 120 Softgels;",,,14.57,,0.00,simple,False,,expense_history_csv,Consolidated_Expense_History_20250622.csv,2025-07-18T12:32:53.413399,3.0,advanced_calculations_v3,exp_v3_000907,2024.00,4.00,2.00,False,False,False,True,40
Ryan,2024-04-12,Mercury,Amazon,,158.30,,"Under Armour Men's ColdGear Armour Leggings, Black (001)/White, Medium; Under Armour Men's Armour HeatGear Compression Long-Sleeve T-Shirt , Black (001)/White , Small;",,,158.30,,2.00,simple,False,Mathematical operation: (001); Mathematical operation: (001),expense_history_csv,Consolidated_Expense_History_20250622.csv,2025-07-18T12:32:53.413399,3.0,advanced_calculations_v3,exp_v3_000908,2024.00,4.00,2.00,False,False,False,True,40
Ryan,2024-04-12,Mercury,Amazon,,31.15,,"Now Supplements, Lutein & Zeaxanthin with 25 mg Lutein and 5 mg Zeaxanthin, 60 Softgels (2 Pack);",,,31.15,,1.00,simple,False,Mathematical operation: (2 Pack),expense_history_csv,Consolidated_Expense_History_20250622.csv,2025-07-18T12:32:53.413399,3.0,advanced_calculations_v3,exp_v3_000909,2024.00,4.00,2.00,False,False,False,True,40
Ryan,2024-04-12,Mercury,Walgreens,,85.36,,,,,85.36,,0.00,simple,False,,expense_history_csv,Consolidated_Expense_History_20250622.csv,2025-07-18T12:32:53.413399,3.0,advanced_calculations_v3,exp_v3_000910,2024.00,4.00,2.00,False,False,False,True,20
Ryan,2024-04-13,Mercury,Amazon,,48.86,,"NOW Supplements, Quercetin with Bromelain, Balanced Immune System*, 120 Veg Capsules;",,,48.86,,0.00,simple,False,,expense_history_csv,Consolidated_Expense_History_20250622.csv,2025-07-18T12:32:53.413399,3.0,advanced_calculations_v3,exp_v3_000911,2024.00,4.00,2.00,False,False,False,True,40
Ryan,2024-04-13,Mercury,Amazon,,65.49,65.49,"2 Pieces Keychain Pill Holder Tiny Keychain Pill Case Titanium Keychain Medication Pill Holder Waterproof Pill Container Portable Titanium Pill Case with Keychain for Men Women Travel Purse Pocket; 5 Pack - Aluminum Keychain Medication Pill Box. Waterproof Portable Mini Travel Pill Boxes Medicine Vitamin Holder case. Bottle Container, Organizer, Dispenser, Reminder Weekly 7 Day, Daily, am pm; Pill Pod 3 Pack - Keychain Pill Holder: Luxe Colors - Micro-Sized & Lightweight with Magnetic Slide - Handmade for Secure Daily Medication Storage (Luxe 3 Pack); We Like Vitamins Diosmin Hesperidin 1000mg – 180 Capsules – 90 Day Supply - Diosmin and Hesperidin Supplement – Helps to Support Healthy Circulation, Veins, Capillaries, and Lymphatic Drainage; NOW Supplements, L-Tyrosine 500 mg, Supports Mental Alertness*, Neurotransmitter Support*, 120 Capsules;",,,65.49,65.49,1.00,simple,False,Mathematical operation: (Luxe 3 Pack),expense_history_csv,Consolidated_Expense_History_20250622.csv,2025-07-18T12:32:53.413399,3.0,advanced_calculations_v3,exp_v3_000912,2024.00,4.00,2.00,False,False,False,True,60
Ryan,2024-04-13,Mercury,Amazon,,145.28,,"Gotu Kola Capsules (Centella Asiatica) 1,000mg of Per Serving (120 Capsules) No Fillers, Vega, Safe, Manufactured in The USA (Gotu Kola Extract for Relaxation and Cognitive Function) by Double Wood; NOW Supplements, Hawthorn Extract 300 mg, Cardiovascular Support*, 90 Veg Capsules; NOW Supplements, Horse Chestnut 300 mg with Added Rutin, Circulatory Support*, 90 Veg Capsules; NOW Supplements, Taurine 1,000 mg, Double Strength, Nervous System Health*, 100 Veg Capsules; Nature Made Vitamin D3 2000 IU (50 mcg), Dietary Supplement for Bone, Teeth, Muscle and Immune Health Support, 400 Tablets, 400 Day Supply; NOW Supplements, Probiotic-10™, 25 Billion, with 10 Probiotic Strains, Dairy, Soy and Gluten Free, Strain Verified, 100 Veg Capsules; NOW Supplements, L-Glutamine 500 mg, Nitrogen Transporter*, Amino Acid, 120 Veg Capsules; Nature Made Magnesium Citrate 250 mg per serving, Dietary Supplement for Muscle, Nerve, Bone and Heart Support, 120 Softgels, 60 Day Supply; Calcium 1200 mg with Vitamin D3, Dietary Supplement for Bone and Teeth Support, Calcium Supplements for Women & Men, Max Absorption Carbonate, Nature's Absorbable Calcium Supplement - 240 Tablets; Nature Made Vitamin E 180 mg (400 IU) dl-Alpha, Dietary Supplement for Antioxidant Support, 300 Softgels, 300 Day Supply; Nature Made Magnesium Glycinate 200 mg per serving, Dietary Supplement for Muscle, Heart, Nerve and Bone Support, 180 Capsules, 90 Day Supply;",,,145.28,,5.00,complex,False,Mathematical operation: (Centella Asiatica); Mathematical operation: (120 Capsules); Mathematical operation: (Gotu Kola Extract for Relaxation and Cognitive Function); Mathematical operation: (50 mcg); Mathematical operation: (400 IU),expense_history_csv,Consolidated_Expense_History_20250622.csv,2025-07-18T12:32:53.413399,3.0,advanced_calculations_v3,exp_v3_000913,2024.00,4.00,2.00,True,False,False,True,40
Ryan,2024-04-13,Mercury,Amazon,,30.42,,"Gotu Kola Capsules (Centella Asiatica) 1,000mg of Per Serving (120 Capsules) No Fillers, Vega, Safe, Manufactured in The USA (Gotu Kola Extract for Relaxation and Cognitive Function) by Double Wood; NOW Supplements, Hawthorn Extract 300 mg, Cardiovascular Support*, 90 Veg Capsules; NOW Supplements, Horse Chestnut 300 mg with Added Rutin, Circulatory Support*, 90 Veg Capsules; NOW Supplements, Taurine 1,000 mg, Double Strength, Nervous System Health*, 100 Veg Capsules; Nature Made Vitamin D3 2000 IU (50 mcg), Dietary Supplement for Bone, Teeth, Muscle and Immune Health Support, 400 Tablets, 400 Day Supply; NOW Supplements, Probiotic-10™, 25 Billion, with 10 Probiotic Strains, Dairy, Soy and Gluten Free, Strain Verified, 100 Veg Capsules; NOW Supplements, L-Glutamine 500 mg, Nitrogen Transporter*, Amino Acid, 120 Veg Capsules; Nature Made Magnesium Citrate 250 mg per serving, Dietary Supplement for Muscle, Nerve, Bone and Heart Support, 120 Softgels, 60 Day Supply; Calcium 1200 mg with Vitamin D3, Dietary Supplement for Bone and Teeth Support, Calcium Supplements for Women & Men, Max Absorption Carbonate, Nature's Absorbable Calcium Supplement - 240 Tablets; Nature Made Vitamin E 180 mg (400 IU) dl-Alpha, Dietary Supplement for Antioxidant Support, 300 Softgels, 300 Day Supply; Nature Made Magnesium Glycinate 200 mg per serving, Dietary Supplement for Muscle, Heart, Nerve and Bone Support, 180 Capsules, 90 Day Supply;",,,30.42,,5.00,complex,False,Mathematical operation: (Centella Asiatica); Mathematical operation: (120 Capsules); Mathematical operation: (Gotu Kola Extract for Relaxation and Cognitive Function); Mathematical operation: (50 mcg); Mathematical operation: (400 IU),expense_history_csv,Consolidated_Expense_History_20250622.csv,2025-07-18T12:32:53.413399,3.0,advanced_calculations_v3,exp_v3_000914,2024.00,4.00,2.00,True,False,False,True,40
Ryan,2024-04-13,Mercury,Target,,33.12,33.12,,,,33.12,33.12,0.00,simple,False,,expense_history_csv,Consolidated_Expense_History_20250622.csv,2025-07-18T12:32:53.413399,3.0,advanced_calculations_v3,exp_v3_000915,2024.00,4.00,2.00,False,False,False,True,40
Ryan,2024-04-13,Mercury,Sendik's,,62.99,,Flowers for mom,,,62.99,,0.00,simple,False,,expense_history_csv,Consolidated_Expense_History_20250622.csv,2025-07-18T12:32:53.413399,3.0,advanced_calculations_v3,exp_v3_000916,2024.00,4.00,2.00,False,False,False,True,40
Ryan,2024-04-14,Mercury,Amazon,,8.61,8.61,"2 Pieces Keychain Pill Holder Tiny Keychain Pill Case Titanium Keychain Medication Pill Holder Waterproof Pill Container Portable Titanium Pill Case with Keychain for Men Women Travel Purse Pocket; 5 Pack - Aluminum Keychain Medication Pill Box. Waterproof Portable Mini Travel Pill Boxes Medicine Vitamin Holder case. Bottle Container, Organizer, Dispenser, Reminder Weekly 7 Day, Daily, am pm; Pill Pod 3 Pack - Keychain Pill Holder: Luxe Colors - Micro-Sized & Lightweight with Magnetic Slide - Handmade for Secure Daily Medication Storage (Luxe 3 Pack); We Like Vitamins Diosmin Hesperidin 1000mg – 180 Capsules – 90 Day Supply - Diosmin and Hesperidin Supplement – Helps to Support Healthy Circulation, Veins, Capillaries, and Lymphatic Drainage; NOW Supplements, L-Tyrosine 500 mg, Supports Mental Alertness*, Neurotransmitter Support*, 120 Capsules;",,,8.61,8.61,1.00,simple,False,Mathematical operation: (Luxe 3 Pack),expense_history_csv,Consolidated_Expense_History_20250622.csv,2025-07-18T12:32:53.413399,3.0,advanced_calculations_v3,exp_v3_000917,2024.00,4.00,2.00,False,False,False,True,60
Ryan,2024-04-15,Mercury,Amazon,,56.29,56.29,,,,56.29,56.29,0.00,simple,False,,expense_history_csv,Consolidated_Expense_History_20250622.csv,2025-07-18T12:32:53.413399,3.0,advanced_calculations_v3,exp_v3_000918,2024.00,4.00,2.00,False,False,False,True,40
Ryan,2024-04-20,Mercury,Amazon,,240.69,,"Under Armour Men's ColdGear Armour Leggings, Black (001)/White, Medium; Under Armour Men's Armour HeatGear Compression Long-Sleeve T-Shirt , Black (001)/White , Small;",,,240.69,,2.00,simple,False,Mathematical operation: (001); Mathematical operation: (001),expense_history_csv,Consolidated_Expense_History_20250622.csv,2025-07-18T12:32:53.413399,3.0,advanced_calculations_v3,exp_v3_000919,2024.00,4.00,2.00,False,False,False,True,40
Ryan,2024-04-20,Mercury,Amazon,,86.14,,"OPTP SI-LOC, SI Joint Belt for Women, Sacroiliac Belt, Lower Back Support Belts for Men, Low Back & Pelvic Pain Relief - Small/Medium;",,,86.14,,0.00,simple,False,,expense_history_csv,Consolidated_Expense_History_20250622.csv,2025-07-18T12:32:53.413399,3.0,advanced_calculations_v3,exp_v3_000920,2024.00,4.00,2.00,False,False,False,True,40
Ryan,2024-04-22,Mercury,Blizzard,,100.00,,"Upgrade for Jordyn Character (Free, No Charge)",,,100.00,,1.00,simple,False,"Mathematical operation: (Free, No Charge)",expense_history_csv,Consolidated_Expense_History_20250622.csv,2025-07-18T12:32:53.413399,3.0,advanced_calculations_v3,exp_v3_000921,2024.00,4.00,2.00,False,False,False,True,40
Ryan,2024-04-27,Mercury,Amazon,,63.13,63.13,"WORLD WIN Smart Led Floor Lamps, RGB Color Changing with APP & Remote Control, 62 Inch DIY Mode Music Sync Standing Modern Corner Lamp Decor for Living Room Bedroom Game, 1 Piece;",,,63.13,63.13,0.00,simple,False,,expense_history_csv,Consolidated_Expense_History_20250622.csv,2025-07-18T12:32:53.413399,3.0,advanced_calculations_v3,exp_v3_000922,2024.00,4.00,2.00,False,False,False,True,60
Ryan,2024-04-28,Mercury,Amazon,,96.92,,"Serola Sacroiliac SI Belt, Medium;",,,96.92,,0.00,simple,False,,expense_history_csv,Consolidated_Expense_History_20250622.csv,2025-07-18T12:32:53.413399,3.0,advanced_calculations_v3,exp_v3_000923,2024.00,4.00,2.00,False,False,False,True,40
Ryan,2024-04-29,Mercury,Amazon,,22.86,,"NOW Supplements, BioCell Collagen® Hydrolyzed Type II, Clinically Validated, 120 Veg Capsules;",,,22.86,,0.00,simple,False,,expense_history_csv,Consolidated_Expense_History_20250622.csv,2025-07-18T12:32:53.413399,3.0,advanced_calculations_v3,exp_v3_000924,2024.00,4.00,2.00,False,False,False,True,40
Ryan,2024-04-29,Mercury,Amazon,,26.27,,"Nature's Bounty Fish Oil 1200 mg, Supports Heart Health With Omega 3 EPA & DHA, 360 Rapid Release Softgels, Twin Pack;",,,26.27,,0.00,simple,False,,expense_history_csv,Consolidated_Expense_History_20250622.csv,2025-07-18T12:32:53.413399,3.0,advanced_calculations_v3,exp_v3_000925,2024.00,4.00,2.00,False,False,False,True,40
Ryan,2024-05-03,Mercury,Amazon,,10.77,,"Logest Metal Hand Grip Set, 100LB-350LB 6 Pack No Slip Heavy-Duty Grip Strengthener with Gift Box, Great Wrist & Forearm Hand Exerciser, Home Gym, Hand Gripper Grip Strength Trainer; Bronson Vitamin K2 as MK-7 Menaquinone 100 mcg Non-GMO, 120 Capsules; Grip Strength Trainer Finger Strengthener-Hand Strengthener 8 Resistant Level Exerciser-Adjustable Hand for Therapy, Relieve Pain Arthritis(Black+Grey, 2PCS); Quality Reusable Earplugs 100 Pair - 25dB Corded Silicone Ear Plugs for Shooting Noise Reduction Construction Work - Motorcycle Ear Plugs with String Hunting Ear Protection Range Hearing Protection;",,,10.77,,1.00,simple,False,"Mathematical operation: (Black+Grey, 2PCS)",expense_history_csv,Consolidated_Expense_History_20250622.csv,2025-07-18T12:32:53.413399,3.0,advanced_calculations_v3,exp_v3_000926,2024.00,5.00,2.00,False,False,False,True,40
Ryan,2024-05-03,Mercury,Amazon,,8.40,,Remember I Love You Mom Gifts for Her Pocket Hug Token for Womens Keychain Accessories for Mom Christmas Birthday Gifts for Women Mother Gifts from Daughter Son Mama Mom Engraved Holiday Gifts Ideas;,,,8.40,,0.00,simple,False,,expense_history_csv,Consolidated_Expense_History_20250622.csv,2025-07-18T12:32:53.413399,3.0,advanced_calculations_v3,exp_v3_000927,2024.00,5.00,2.00,False,False,False,True,40
Ryan,2024-05-04,Mercury,Amazon,,30.51,30.51,"TV Antenna,TV Antenna Indoor, HD Antenna for Smart TV and All TV,TV Antenna for Local Channels,Support 4K 1080p with Signal Booster Antenna TV Digital HD Indoor & Outdoor- 15FT Coax HDTV Cable;",,,30.51,30.51,0.00,simple,False,,expense_history_csv,Consolidated_Expense_History_20250622.csv,2025-07-18T12:32:53.413399,3.0,advanced_calculations_v3,exp_v3_000928,2024.00,5.00,2.00,False,False,False,True,60
Ryan,2024-05-04,Mercury,Amazon,,29.39,,"Pet Memorial Wind Chime - 18"" Metal Casted Pawprint Wind Chime - A Beautiful Remembrance Gift for a Grieving Pet Owner - Includes Pawprints Left by You Poem Card;",,,29.39,,0.00,simple,False,,expense_history_csv,Consolidated_Expense_History_20250622.csv,2025-07-18T12:32:53.413399,3.0,advanced_calculations_v3,exp_v3_000929,2024.00,5.00,2.00,False,False,False,True,40
Ryan,2024-05-09,Mercury,Blizzard,,16.17,,,,,16.17,,0.00,simple,False,,expense_history_csv,Consolidated_Expense_History_20250622.csv,2025-07-18T12:32:53.413399,3.0,advanced_calculations_v3,exp_v3_000930,2024.00,5.00,2.00,False,False,False,True,20
Ryan,2024-05-10,Mercury,Amazon,,22.97,,"NOW Silymarin 2X - 300 mg,200 Veg Capsules;",,,22.97,,0.00,simple,False,,expense_history_csv,Consolidated_Expense_History_20250622.csv,2025-07-18T12:32:53.413399,3.0,advanced_calculations_v3,exp_v3_000931,2024.00,5.00,2.00,False,False,False,True,40
Ryan,2024-05-10,Mercury,Amazon,,29.40,29.40,"Membrane Solutions 10 Pack Syringe Filter Sterile PES Hydrophilic Filtration 0.22um Pore Size, 33mm Membrane Diameter Sterile PES Membrane Individually Packed;",,,29.40,29.40,0.00,simple,False,,expense_history_csv,Consolidated_Expense_History_20250622.csv,2025-07-18T12:32:53.413399,3.0,advanced_calculations_v3,exp_v3_000932,2024.00,5.00,2.00,False,False,False,True,60
Ryan,2024-05-10,Mercury,Aamzon,,37.99,,,,,37.99,,0.00,simple,False,,expense_history_csv,Consolidated_Expense_History_20250622.csv,2025-07-18T12:32:53.413399,3.0,advanced_calculations_v3,exp_v3_000933,2024.00,5.00,2.00,False,False,False,True,20
Ryan,2024-05-15,Mercury,Amazon,,13.55,13.55,"Uineko Plastic Spray Bottle (4 Pack, 24 Oz, All-Purpose) Heavy Duty Spraying Bottles Leak Proof Mist Empty Water Bottle for Cleaning Solution Planting Pet with Adjustable Nozzle and Measurements;",,,13.55,13.55,1.00,simple,False,"Mathematical operation: (4 Pack, 24 Oz, All-Purpose)",expense_history_csv,Consolidated_Expense_History_20250622.csv,2025-07-18T12:32:53.413399,3.0,advanced_calculations_v3,exp_v3_000934,2024.00,5.00,2.00,False,False,False,True,60
Ryan,2024-05-19,Mercury,Aamzon Prime,,4.30,4.30,Back to the Future;,,,4.30,4.30,0.00,simple,False,,expense_history_csv,Consolidated_Expense_History_20250622.csv,2025-07-18T12:32:53.413399,3.0,advanced_calculations_v3,exp_v3_000935,2024.00,5.00,2.00,False,False,False,True,60
Ryan,2024-05-20,Mercury,Amazon,,13.57,13.57,"ZAMAT Contour Memory Foam Pillow for Neck Pain Relief, Adjustable Ergonomic Cervical Pillow for Sleeping, Orthopedic Neck Pillow with Washable Cover, Bed Pillows for Side, Back, Stomach Sleepers; 6 Pack Reusable Mop Pads Compatible with Swiffer PowerMop, Power Mop Refills Power Mop Refill Pads Wet Pads Refill Mop Pads Refills Machine Washable Thicken Microfiber Mop Pads for Hardwood Floor; 20ml Luer Lock Syringe 20-Pack Plastic 20ml Syringes with Luer Lock Tip, Individually Sterile Sealed, No Needle (20ML, 20.00); Membrane Solutions 10 Pack Syringe Filter Sterile PES Hydrophilic Filtration 0.22um Pore Size, 33mm Membrane Diameter Sterile PES Membrane Individually Packed; LEONC Design Floor Lamp, LEONC Standing Lamp, RGB 7 Colors Changing LED Bulbs and 10 Levels Brightness, Remote Control and Fabric Shade, Modern for Bedroom, Kids Room and Play Room;",,,13.57,13.57,1.00,simple,False,"Mathematical operation: (20ML, 20.00)",expense_history_csv,Consolidated_Expense_History_20250622.csv,2025-07-18T12:32:53.413399,3.0,advanced_calculations_v3,exp_v3_000936,2024.00,5.00,2.00,False,False,False,True,60
Ryan,2024-05-23,Mercury,Amazon,,43.10,,"DEVOPS 3 Pack Men's Athletic Compression Shirts Sleeveless (Small, Black/Black/Black); DEVOPS 3 Pack Men's Dry-Fit Workout Tank Tops Gym Sleeveless Shirts (Medium, Z Black 3 Pack); DEVOPS 3 Pack Men's Athletic Compression Shirts Sleeveless (Medium, Black/Black/Black);",,,43.10,,3.00,complex,False,"Mathematical operation: (Small, Black/Black/Black); Mathematical operation: (Medium, Z Black 3 Pack); Mathematical operation: (Medium, Black/Black/Black)",expense_history_csv,Consolidated_Expense_History_20250622.csv,2025-07-18T12:32:53.413399,3.0,advanced_calculations_v3,exp_v3_000937,2024.00,5.00,2.00,True,False,False,True,40
Ryan,2024-05-23,Mercury,Amazon,,21.55,,"DEVOPS 3 Pack Men's Athletic Compression Shirts Sleeveless (Small, Black/Black/Black); DEVOPS 3 Pack Men's Dry-Fit Workout Tank Tops Gym Sleeveless Shirts (Medium, Z Black 3 Pack); DEVOPS 3 Pack Men's Athletic Compression Shirts Sleeveless (Medium, Black/Black/Black);",,,21.55,,3.00,complex,False,"Mathematical operation: (Small, Black/Black/Black); Mathematical operation: (Medium, Z Black 3 Pack); Mathematical operation: (Medium, Black/Black/Black)",expense_history_csv,Consolidated_Expense_History_20250622.csv,2025-07-18T12:32:53.413399,3.0,advanced_calculations_v3,exp_v3_000938,2024.00,5.00,2.00,True,False,False,True,40
Ryan,2024-05-27,Mercury,Amazon Prime,,4.09,4.09,Freaky;,,,4.09,4.09,0.00,simple,False,,expense_history_csv,Consolidated_Expense_History_20250622.csv,2025-07-18T12:32:53.413399,3.0,advanced_calculations_v3,exp_v3_000939,2024.00,5.00,2.00,False,False,False,True,60
Ryan,2024-06-06,Mercury,Amazon,,14.00,14.00,"100 Pack 3ml Syringes Luer Lock Syringe without Needle, Individually Sterile Wrapped, with Cap;",,,14.00,14.00,0.00,simple,False,,expense_history_csv,Consolidated_Expense_History_20250622.csv,2025-07-18T12:32:53.413399,3.0,advanced_calculations_v3,exp_v3_000940,2024.00,6.00,2.00,False,False,False,True,60
Ryan,2024-06-08,Mercury,Amazon Prime,,4.09,4.09,Inside Out;,,,4.09,4.09,0.00,simple,False,,expense_history_csv,Consolidated_Expense_History_20250622.csv,2025-07-18T12:32:53.413399,3.0,advanced_calculations_v3,exp_v3_000941,2024.00,6.00,2.00,False,False,False,True,60
Ryan,2024-06-08,Mercury,Amazon,,19.45,19.45,"Care Touch CTSLL10 10mL Syringe Only - Luer Lock Syringe Tip (No Needle),100 Count (Pack of 1);",,,19.45,19.45,2.00,simple,False,Mathematical operation: (No Needle); Mathematical operation: (Pack of 1),expense_history_csv,Consolidated_Expense_History_20250622.csv,2025-07-18T12:32:53.413399,3.0,advanced_calculations_v3,exp_v3_000942,2024.00,6.00,2.00,False,False,False,True,60
Ryan,2024-06-08,Mercury,Mesmerica,,34.57,34.57,Dining Out,,,34.57,34.57,0.00,simple,False,,expense_history_csv,Consolidated_Expense_History_20250622.csv,2025-07-18T12:32:53.413399,3.0,advanced_calculations_v3,exp_v3_000943,2024.00,6.00,2.00,False,False,False,True,60
Ryan,2024-06-08,Mercury,Harkins,,29.50,29.50,Entertainment,,,29.50,29.50,0.00,simple,False,,expense_history_csv,Consolidated_Expense_History_20250622.csv,2025-07-18T12:32:53.413399,3.0,advanced_calculations_v3,exp_v3_000944,2024.00,6.00,2.00,False,False,False,True,60
Ryan,2024-06-09,Mercury,Blizzard,,16.17,16.17,Entertainment,,,16.17,16.17,0.00,simple,False,,expense_history_csv,Consolidated_Expense_History_20250622.csv,2025-07-18T12:32:53.413399,3.0,advanced_calculations_v3,exp_v3_000945,2024.00,6.00,2.00,False,False,False,True,60
Ryan,2024-06-09,Mercury,Amazon Prime,,12.93,12.93,What Should Danny Do? (The Power to Choose Series);,,,12.93,12.93,1.00,simple,False,Mathematical operation: (The Power to Choose Series),expense_history_csv,Consolidated_Expense_History_20250622.csv,2025-07-18T12:32:53.413399,3.0,advanced_calculations_v3,exp_v3_000946,2024.00,6.00,2.00,False,False,False,True,60
Ryan,2024-06-10,Mercury,Amazon,,25.86,,"VIVO Steel Reinforcement Bracket Mount Plate for Thin, Glass, and Other Fragile Table Tops, Clamp Compatible with Most Monitor Stand C-Clamp Installations, Black, STAND-AC01R; MOUNTUP Monitor Mount Reinforcement for Tempered Glass Desk, Monitor Arm Plate, Steel Bracket for Thin and Most Fragile Table, for Desk C Clamp Installation of Monitor Stand; CompressionZ Compression Arm Sleeves for Men & Women UV Protection (Black, M); RENPHO Eyeris 2 Extended - Eye Massager with Heating Pad for Migraines, Heated Eye Mask for Relax, Eye Care, Face Massager for Eye Strain Eye Bags Dry Eyes, Improve Sleep, Ideal Birthday Gift; Govee RGBIC Table Lamp, Smart Lamp Work with Alexa, LED Lamp with Music Sync and 43 Scene Modes, Color Changing Lamp for Bedroom Decor, Dimmable Night Light (Corded Electric); 6 Pack Reusable Mop Pads Compatible with Swiffer Powermop, Papclean Power Mop Refills Microfiber Power Mop Mopping Pads for Powermop Multi-Surface & Wood Mop Kit All Types of Floor Cleaning, Purple;",,,25.86,,5.00,complex,True,"Mathematical operation: (Black, M); Mathematical operation: (Corded Electric); Manual review required: Monitor",expense_history_csv,Consolidated_Expense_History_20250622.csv,2025-07-18T12:32:53.413399,3.0,advanced_calculations_v3,exp_v3_000947,2024.00,6.00,2.00,True,False,False,True,20
Ryan,2024-06-11,Mercury,Amazon,,41.39,41.39,"Rapid Response Fentanyl Test Strips - 5 Test Strips Per Pack - #1 Global Selling Fentanyl Strips - Harm Reduction Tool - Overdose Prevention; Rapid Response Xylazine Test Strips - #1 Global Selling Xylazine Strips - Harm Reduction Tool - Overdose Prevention (5); Areta Multi-Drug Test Cup: 14 Panel at Home Drug Test Kit, Testing 14 Drugs BUP,THC,OPI 2000, AMP,BAR,BZO,COC,MET,MDMA,MTD,OXY,PCP,PPX,TCA-#ACDOA-1144-5 Pack;",,,41.39,41.39,2.00,simple,False,Mathematical operation: 1144-5; Mathematical operation: (5),expense_history_csv,Consolidated_Expense_History_20250622.csv,2025-07-18T12:32:53.413399,3.0,advanced_calculations_v3,exp_v3_000948,2024.00,6.00,2.00,False,False,False,True,60
Ryan,2024-06-11,Mercury,Whole Foods,,20.29,20.29,Food,,,20.29,20.29,0.00,simple,False,,expense_history_csv,Consolidated_Expense_History_20250622.csv,2025-07-18T12:32:53.413399,3.0,advanced_calculations_v3,exp_v3_000949,2024.00,6.00,2.00,False,False,False,True,60
Ryan,2024-06-12,Mercury,Amazon,,74.83,74.83,"AUVON Large Insulin Cooler Travel Case, Longer Cooling Effect with 4 * 160g Ice Packs, Compact Medication Cooler Bag for 8 Insulin Pens and Diabetic Supplies, Ideal Travel Partner with Handle Design; Hydro Flask Standard Flex Cap Black 24 Oz; AUVON Insulin Cooler Travel Case, Expandable Insulated Diabetic Bag with 2 * 180g Ice Packs for Double Cooling Time, Portable Medication Cooler Bag for Insulin Pens and Blood Glucose Monitor Supplies;",,,74.83,74.83,5.00,complex,True,Mathematical operation: 4 * 160; Mathematical operation: 2 * 180; Manual review required: Monitor,expense_history_csv,Consolidated_Expense_History_20250622.csv,2025-07-18T12:32:53.413399,3.0,advanced_calculations_v3,exp_v3_000950,2024.00,6.00,2.00,True,False,False,True,40
Ryan,2024-06-13,Mercury,Amazon,,9.85,,Standard Mouth Sport Cap Black; Hydro Flask Standard Flex Cap Dew 24 Oz;,,,9.85,,0.00,simple,False,,expense_history_csv,Consolidated_Expense_History_20250622.csv,2025-07-18T12:32:53.413399,3.0,advanced_calculations_v3,exp_v3_000951,2024.00,6.00,2.00,False,False,False,True,40
Ryan,2024-06-14,Mercury,Amazon,,27.26,27.26,"Kleenex Ultra Soft Facial Tissues, 3 Flat Boxes, 120 Tissues per Box, 3-Ply (360 Total Tissues), Packaging May Vary; Amazon Basics Sky Blue Cabana Stripe Pool & Beach Towel, 100% Cotton, Soft & Absorbant, 2 Pack, 30"" x 60"";",,,27.26,27.26,1.00,simple,False,Mathematical operation: (360 Total Tissues),expense_history_csv,Consolidated_Expense_History_20250622.csv,2025-07-18T12:32:53.413399,3.0,advanced_calculations_v3,exp_v3_000952,2024.00,6.00,2.00,False,False,False,True,60
Ryan,2024-06-14,Mercury,Amazon,,30.07,30.07,Standard Mouth Sport Cap Black; Hydro Flask Standard Flex Cap Dew 24 Oz;,,,30.07,30.07,0.00,simple,False,,expense_history_csv,Consolidated_Expense_History_20250622.csv,2025-07-18T12:32:53.413399,3.0,advanced_calculations_v3,exp_v3_000953,2024.00,6.00,2.00,False,False,False,True,60
Ryan,2024-06-20,,Amazon,,29.21,29.21,"Rapid Response Fentanyl Test Strips, .22 um",,,29.21,29.21,0.00,simple,False,,expense_history_csv,Consolidated_Expense_History_20250622.csv,2025-07-18T12:32:53.413399,3.0,advanced_calculations_v3,exp_v3_000954,2024.00,6.00,2.00,False,False,False,True,60
Ryan,2024-06-21,,Amazon,,49.47,49.47,TP-Link AC1750 WiFi Extender,,,49.47,49.47,0.00,simple,False,,expense_history_csv,Consolidated_Expense_History_20250622.csv,2025-07-18T12:32:53.413399,3.0,advanced_calculations_v3,exp_v3_000955,2024.00,6.00,2.00,False,False,False,True,60
Ryan,2024-06-23,,PlayStation Network,,43.11,43.11,PSN,,,43.11,43.11,0.00,simple,False,,expense_history_csv,Consolidated_Expense_History_20250622.csv,2025-07-18T12:32:53.413399,3.0,advanced_calculations_v3,exp_v3_000956,2024.00,6.00,2.00,False,False,False,True,60
Ryan,2024-06-24,,Amazon,,5.63,5.63,Zinc,,,5.63,5.63,0.00,simple,False,,expense_history_csv,Consolidated_Expense_History_20250622.csv,2025-07-18T12:32:53.413399,3.0,advanced_calculations_v3,exp_v3_000957,2024.00,6.00,2.00,False,False,False,True,60
Ryan,2024-06-24,,Amazon,,13.63,13.63,.22 um,,,13.63,13.63,0.00,simple,False,,expense_history_csv,Consolidated_Expense_History_20250622.csv,2025-07-18T12:32:53.413399,3.0,advanced_calculations_v3,exp_v3_000958,2024.00,6.00,2.00,False,False,False,True,60
Ryan,2024-06-30,,Whole Foods,,70.09,70.09,Wine / Food,,,70.09,70.09,0.00,simple,False,,expense_history_csv,Consolidated_Expense_History_20250622.csv,2025-07-18T12:32:53.413399,3.0,advanced_calculations_v3,exp_v3_000959,2024.00,6.00,2.00,False,False,False,True,60
Ryan,2024-07-02,,Amazon,,45.95,45.95,"Burt's Bees, Vet's Best, Dog Oral Care Additive",,,45.95,45.95,0.00,simple,False,,expense_history_csv,Consolidated_Expense_History_20250622.csv,2025-07-18T12:32:53.413399,3.0,advanced_calculations_v3,exp_v3_000960,2024.00,7.00,3.00,False,False,False,True,60
Ryan,2024-05-04,Ally,Amazon,,10.66,10.66,Rapid Response Fentanyl Test Strips - 5 Test Strips Per Pack - #1 Global Selling Fentanyl Strips - Harm Reduction Tool - Overdose Prevention;,,,10.66,10.66,0.00,simple,False,,expense_history_csv,Consolidated_Expense_History_20250622.csv,2025-07-18T12:32:53.413399,3.0,advanced_calculations_v3,exp_v3_000961,2024.00,5.00,2.00,False,False,False,True,60
Ryan,2024-05-19,Ally,Amazon,,33.87,33.87,"Membrane Solutions 20 Pack Syringe Filter Sterile PES Hydrophilic Filtration 0.22um Pore Size, 33mm Membrane Diameter Sterile PES Membrane Individually Packed;",,,33.87,33.87,0.00,simple,False,,expense_history_csv,Consolidated_Expense_History_20250622.csv,2025-07-18T12:32:53.413399,3.0,advanced_calculations_v3,exp_v3_000962,2024.00,5.00,2.00,False,False,False,True,60
Ryan,2024-05-19,Ally,Amazon,,22.99,22.99,"Semmerfeld 10 Pack PES Sterile Syringe Filter 0.22um Pore Size 22 Micron Hydrophilic Filtration, 33mm Diameter Sterile Individually Packed PES Membrane; 10ml Luer Lock Syringe 20-Pack Plastic 10ml Syringes with Luer Lock Tip, Individually Sterile Sealed, No Needle;",,,22.99,22.99,0.00,simple,False,,expense_history_csv,Consolidated_Expense_History_20250622.csv,2025-07-18T12:32:53.413399,3.0,advanced_calculations_v3,exp_v3_000963,2024.00,5.00,2.00,False,False,False,True,60
Ryan,2024-03-27,Target RedCard,Target,,85.33,85.33,"Charmin, Cascade, Bounty",,,85.33,85.33,0.00,simple,False,,expense_history_csv,Consolidated_Expense_History_20250622.csv,2025-07-18T12:32:53.413399,3.0,advanced_calculations_v3,exp_v3_000964,2024.00,3.00,1.00,False,False,False,True,60
Ryan,2024-04-10,Target RedCard,Target,,239.59,239.59,20 + Household Items,,,239.59,239.59,0.00,simple,False,,expense_history_csv,Consolidated_Expense_History_20250622.csv,2025-07-18T12:32:53.413399,3.0,advanced_calculations_v3,exp_v3_000965,2024.00,4.00,2.00,False,False,False,True,60
Ryan,2024-02-22,Best Buy Citi,Best Buy,,146.00,,TV,,,146.00,,0.00,simple,False,,expense_history_csv,Consolidated_Expense_History_20250622.csv,2025-07-18T12:32:53.413399,3.0,advanced_calculations_v3,exp_v3_000966,2024.00,2.00,1.00,False,False,False,True,40
Ryan,2024-03-22,Best Buy Citi,Best Buy,,146.00,,TV,,,146.00,,0.00,simple,False,,expense_history_csv,Consolidated_Expense_History_20250622.csv,2025-07-18T12:32:53.413399,3.0,advanced_calculations_v3,exp_v3_000967,2024.00,3.00,1.00,False,False,False,True,40
Ryan,2024-04-22,Best Buy Citi,Best Buy,,146.00,,TV,,,146.00,,0.00,simple,False,,expense_history_csv,Consolidated_Expense_History_20250622.csv,2025-07-18T12:32:53.413399,3.0,advanced_calculations_v3,exp_v3_000968,2024.00,4.00,2.00,False,False,False,True,40
Ryan,2024-05-22,Best Buy Citi,Best Buy,,146.00,,TV,,,146.00,,0.00,simple,False,,expense_history_csv,Consolidated_Expense_History_20250622.csv,2025-07-18T12:32:53.413399,3.0,advanced_calculations_v3,exp_v3_000969,2024.00,5.00,2.00,False,False,False,True,40
Ryan,2024-06-22,Best Buy Citi,Best Buy,,146.00,,TV,,,146.00,,0.00,simple,False,,expense_history_csv,Consolidated_Expense_History_20250622.csv,2025-07-18T12:32:53.413399,3.0,advanced_calculations_v3,exp_v3_000970,2024.00,6.00,2.00,False,False,False,True,40
Ryan,2024-03-20,Credit One x1559,Best Buy,,38.00,,TV,,,38.00,,0.00,simple,False,,expense_history_csv,Consolidated_Expense_History_20250622.csv,2025-07-18T12:32:53.413399,3.0,advanced_calculations_v3,exp_v3_000971,2024.00,3.00,1.00,False,False,False,True,40
Ryan,2024-04-13,Credit One x9585,Starz (Amazon),,10.77,10.77,Starz Subscription,,,10.77,10.77,0.00,simple,False,,expense_history_csv,Consolidated_Expense_History_20250622.csv,2025-07-18T12:32:53.413399,3.0,advanced_calculations_v3,exp_v3_000972,2024.00,4.00,2.00,False,False,False,True,60
Ryan,2024-03-14,Apple Wallet,Bro,,230.00,230.00,N/A,,,230.00,230.00,0.00,simple,False,,expense_history_csv,Consolidated_Expense_History_20250622.csv,2025-07-18T12:32:53.413399,3.0,advanced_calculations_v3,exp_v3_000973,2024.00,3.00,1.00,False,False,False,True,60
Ryan,2024-03-18,Apple Wallet,Bro,,450.00,450.00,N/A,,,450.00,450.00,0.00,simple,False,,expense_history_csv,Consolidated_Expense_History_20250622.csv,2025-07-18T12:32:53.413399,3.0,advanced_calculations_v3,exp_v3_000974,2024.00,3.00,1.00,False,False,False,True,60
Ryan,2024-03-28,Apple Pay,Bro,,450.00,450.00,N/A,,,450.00,450.00,0.00,simple,False,,expense_history_csv,Consolidated_Expense_History_20250622.csv,2025-07-18T12:32:53.413399,3.0,advanced_calculations_v3,exp_v3_000975,2024.00,3.00,1.00,False,False,False,True,60
Ryan,2024-04-07,Apple Pay,Bro,,450.00,450.00,N/A,,,450.00,450.00,0.00,simple,False,,expense_history_csv,Consolidated_Expense_History_20250622.csv,2025-07-18T12:32:53.413399,3.0,advanced_calculations_v3,exp_v3_000976,2024.00,4.00,2.00,False,False,False,True,60
Ryan,2024-04-18,Apple Pay,Bro,,230.00,230.00,N/A,,,230.00,230.00,0.00,simple,False,,expense_history_csv,Consolidated_Expense_History_20250622.csv,2025-07-18T12:32:53.413399,3.0,advanced_calculations_v3,exp_v3_000977,2024.00,4.00,2.00,False,False,False,True,60
Ryan,2024-04-24,Apple Pay,Bro,,230.00,230.00,N/A,,,230.00,230.00,0.00,simple,False,,expense_history_csv,Consolidated_Expense_History_20250622.csv,2025-07-18T12:32:53.413399,3.0,advanced_calculations_v3,exp_v3_000978,2024.00,4.00,2.00,False,False,False,True,60
Ryan,2024-04-27,Apple Pay,Bro,,225.00,225.00,N/A,,,225.00,225.00,0.00,simple,False,,expense_history_csv,Consolidated_Expense_History_20250622.csv,2025-07-18T12:32:53.413399,3.0,advanced_calculations_v3,exp_v3_000979,2024.00,4.00,2.00,False,False,False,True,60
Ryan,2024-05-03,Apple Pay,Bro,,225.00,225.00,N/A,,,225.00,225.00,0.00,simple,False,,expense_history_csv,Consolidated_Expense_History_20250622.csv,2025-07-18T12:32:53.413399,3.0,advanced_calculations_v3,exp_v3_000980,2024.00,5.00,2.00,False,False,False,True,60
Ryan,2024-05-07,Apple Pay,Bro,,450.00,450.00,N/A,,,450.00,450.00,0.00,simple,False,,expense_history_csv,Consolidated_Expense_History_20250622.csv,2025-07-18T12:32:53.413399,3.0,advanced_calculations_v3,exp_v3_000981,2024.00,5.00,2.00,False,False,False,True,60
Ryan,2024-05-26,Apple Pay,Bro,,225.00,225.00,N/A,,,225.00,225.00,0.00,simple,False,,expense_history_csv,Consolidated_Expense_History_20250622.csv,2025-07-18T12:32:53.413399,3.0,advanced_calculations_v3,exp_v3_000982,2024.00,5.00,2.00,False,False,False,True,60
Ryan,2024-06-04,Apple Pay,Bro,,225.00,225.00,N/A,,,225.00,225.00,0.00,simple,False,,expense_history_csv,Consolidated_Expense_History_20250622.csv,2025-07-18T12:32:53.413399,3.0,advanced_calculations_v3,exp_v3_000983,2024.00,6.00,2.00,False,False,False,True,60
Ryan,2024-06-14,Apple Pay,Bro,,225.00,225.00,N/A,,,225.00,225.00,0.00,simple,False,,expense_history_csv,Consolidated_Expense_History_20250622.csv,2025-07-18T12:32:53.413399,3.0,advanced_calculations_v3,exp_v3_000984,2024.00,6.00,2.00,False,False,False,True,60
Ryan,2024-06-17,Apple Pay,Bro,,225.00,225.00,N/A,,,225.00,225.00,0.00,simple,False,,expense_history_csv,Consolidated_Expense_History_20250622.csv,2025-07-18T12:32:53.413399,3.0,advanced_calculations_v3,exp_v3_000985,2024.00,6.00,2.00,False,False,False,True,60
Ryan,2024-06-20,Apple Pay,Bro,,225.00,225.00,N/A,,,225.00,225.00,0.00,simple,False,,expense_history_csv,Consolidated_Expense_History_20250622.csv,2025-07-18T12:32:53.413399,3.0,advanced_calculations_v3,exp_v3_000986,2024.00,6.00,2.00,False,False,False,True,60
Ryan,2024-06-24,Apple Pay,Bro,,225.00,225.00,N/A,,,225.00,225.00,0.00,simple,False,,expense_history_csv,Consolidated_Expense_History_20250622.csv,2025-07-18T12:32:53.413399,3.0,advanced_calculations_v3,exp_v3_000987,2024.00,6.00,2.00,False,False,False,True,60
Ryan,2024-06-30,Apple Pay,Bro,,225.00,225.00,N/A,,,225.00,225.00,0.00,simple,False,,expense_history_csv,Consolidated_Expense_History_20250622.csv,2025-07-18T12:32:53.413399,3.0,advanced_calculations_v3,exp_v3_000988,2024.00,6.00,2.00,False,False,False,True,60
Ryan,2024-03-28,Apple Pay,Rebecca,,220.00,220.00,N/A,,,220.00,220.00,0.00,simple,False,,expense_history_csv,Consolidated_Expense_History_20250622.csv,2025-07-18T12:32:53.413399,3.0,advanced_calculations_v3,exp_v3_000989,2024.00,3.00,1.00,False,False,False,True,60
Ryan,2024-03-19,Cash,Rebecca,,220.00,220.00,N/A,,,220.00,220.00,0.00,simple,False,,expense_history_csv,Consolidated_Expense_History_20250622.csv,2025-07-18T12:32:53.413399,3.0,advanced_calculations_v3,exp_v3_000990,2024.00,3.00,1.00,False,False,False,True,60
Ryan,2024-04-09,Cash,Rebecca,,220.00,220.00,N/A,,,220.00,220.00,0.00,simple,False,,expense_history_csv,Consolidated_Expense_History_20250622.csv,2025-07-18T12:32:53.413399,3.0,advanced_calculations_v3,exp_v3_000991,2024.00,4.00,2.00,False,False,False,True,60
Ryan,2024-04-23,Cash,Rebecca,,220.00,220.00,N/A,,,220.00,220.00,0.00,simple,False,,expense_history_csv,Consolidated_Expense_History_20250622.csv,2025-07-18T12:32:53.413399,3.0,advanced_calculations_v3,exp_v3_000992,2024.00,4.00,2.00,False,False,False,True,60
Ryan,2024-05-07,Cash,Rebecca,,220.00,220.00,N/A,,,220.00,220.00,0.00,simple,False,,expense_history_csv,Consolidated_Expense_History_20250622.csv,2025-07-18T12:32:53.413399,3.0,advanced_calculations_v3,exp_v3_000993,2024.00,5.00,2.00,False,False,False,True,60
Ryan,2024-05-16,Cash,Rebecca,,220.00,220.00,N/A,,,220.00,220.00,0.00,simple,False,,expense_history_csv,Consolidated_Expense_History_20250622.csv,2025-07-18T12:32:53.413399,3.0,advanced_calculations_v3,exp_v3_000994,2024.00,5.00,2.00,False,False,False,True,60
Ryan,2024-05-24,Cash,Rebecca,,220.00,220.00,N/A,,,220.00,220.00,0.00,simple,False,,expense_history_csv,Consolidated_Expense_History_20250622.csv,2025-07-18T12:32:53.413399,3.0,advanced_calculations_v3,exp_v3_000995,2024.00,5.00,2.00,False,False,False,True,60
Ryan,2024-06-04,Cash,Rebecca,,220.00,220.00,N/A,,,220.00,220.00,0.00,simple,False,,expense_history_csv,Consolidated_Expense_History_20250622.csv,2025-07-18T12:32:53.413399,3.0,advanced_calculations_v3,exp_v3_000996,2024.00,6.00,2.00,False,False,False,True,60
Ryan,2024-06-14,Cash,Rebecca,,220.00,220.00,N/A,,,220.00,220.00,0.00,simple,False,,expense_history_csv,Consolidated_Expense_History_20250622.csv,2025-07-18T12:32:53.413399,3.0,advanced_calculations_v3,exp_v3_000997,2024.00,6.00,2.00,False,False,False,True,60
Ryan,2024-06-17,Cash,Rebecca,,220.00,220.00,N/A,,,220.00,220.00,0.00,simple,False,,expense_history_csv,Consolidated_Expense_History_20250622.csv,2025-07-18T12:32:53.413399,3.0,advanced_calculations_v3,exp_v3_000998,2024.00,6.00,2.00,False,False,False,True,60
Ryan,2024-06-24,Cash,Rebecca,,62.85,62.85,N/A,,,62.85,62.85,0.00,simple,False,,expense_history_csv,Consolidated_Expense_History_20250622.csv,2025-07-18T12:32:53.413399,3.0,advanced_calculations_v3,exp_v3_000999,2024.00,6.00,2.00,False,False,False,True,60
Jordyn,2024-03-12,Wells Fargo,The Vig,,18.00,18.00,,,,18.00,18.00,0.00,simple,False,,expense_history_csv,Consolidated_Expense_History_20250622.csv,2025-07-18T12:32:53.413399,3.0,advanced_calculations_v3,exp_v3_001000,2024.00,3.00,1.00,False,False,False,True,40
Jordyn,2024-03-12,Wells Fargo,Gurtrude's,,48.26,48.26,,,,48.26,48.26,0.00,simple,False,,expense_history_csv,Consolidated_Expense_History_20250622.csv,2025-07-18T12:32:53.413399,3.0,advanced_calculations_v3,exp_v3_001001,2024.00,3.00,1.00,False,False,False,True,40
Jordyn,2024-03-14,Wells Fargo,Fry's,,33.32,33.32,,,,33.32,33.32,0.00,simple,False,,expense_history_csv,Consolidated_Expense_History_20250622.csv,2025-07-18T12:32:53.413399,3.0,advanced_calculations_v3,exp_v3_001002,2024.00,3.00,1.00,False,False,False,True,40
Jordyn,2024-03-15,Wells Fargo,Cooper's Hawk,,47.44,47.44,,,,47.44,47.44,0.00,simple,False,,expense_history_csv,Consolidated_Expense_History_20250622.csv,2025-07-18T12:32:53.413399,3.0,advanced_calculations_v3,exp_v3_001003,2024.00,3.00,1.00,False,False,False,True,40
Jordyn,2024-03-16,Wells Fargo,Ostrich Fest,,19.00,19.00,,,,19.00,19.00,0.00,simple,False,,expense_history_csv,Consolidated_Expense_History_20250622.csv,2025-07-18T12:32:53.413399,3.0,advanced_calculations_v3,exp_v3_001004,2024.00,3.00,1.00,False,False,False,True,40
Jordyn,2024-03-16,Wells Fargo,Los Taquitos,,23.46,23.46,,,,23.46,23.46,0.00,simple,False,,expense_history_csv,Consolidated_Expense_History_20250622.csv,2025-07-18T12:32:53.413399,3.0,advanced_calculations_v3,exp_v3_001005,2024.00,3.00,1.00,False,False,False,True,40
Jordyn,2024-03-16,Wells Fargo,Whole Foods,,9.12,9.12,,,,9.12,9.12,0.00,simple,False,,expense_history_csv,Consolidated_Expense_History_20250622.csv,2025-07-18T12:32:53.413399,3.0,advanced_calculations_v3,exp_v3_001006,2024.00,3.00,1.00,False,False,False,True,40
Jordyn,2024-03-19,Wells Fargo,Amazon,,68.92,68.92,"GlutenEase, Generic Xyxal",,,68.92,68.92,0.00,simple,False,,expense_history_csv,Consolidated_Expense_History_20250622.csv,2025-07-18T12:32:53.413399,3.0,advanced_calculations_v3,exp_v3_001007,2024.00,3.00,1.00,False,False,False,True,60
Jordyn,2024-03-19,Wells Fargo,Fry's,,150.46,150.46,,,,150.46,150.46,0.00,simple,False,,expense_history_csv,Consolidated_Expense_History_20250622.csv,2025-07-18T12:32:53.413399,3.0,advanced_calculations_v3,exp_v3_001008,2024.00,3.00,1.00,False,False,False,True,40
Jordyn,2024-03-20,Wells Fargo,Fry's,,35.86,35.86,,,,35.86,35.86,0.00,simple,False,,expense_history_csv,Consolidated_Expense_History_20250622.csv,2025-07-18T12:32:53.413399,3.0,advanced_calculations_v3,exp_v3_001009,2024.00,3.00,1.00,False,False,False,True,40
Jordyn,2024-03-22,Wells Fargo,Amazon,,36.80,36.80,"Paint Tray, Paint Set, Wood Easel, Paint",,,36.80,36.80,0.00,simple,False,,expense_history_csv,Consolidated_Expense_History_20250622.csv,2025-07-18T12:32:53.413399,3.0,advanced_calculations_v3,exp_v3_001010,2024.00,3.00,1.00,False,False,False,True,60
Jordyn,2024-03-23,Wells Fargo,Spinatto's Pizza,,124.22,124.22,,,,124.22,124.22,0.00,simple,False,,expense_history_csv,Consolidated_Expense_History_20250622.csv,2025-07-18T12:32:53.413399,3.0,advanced_calculations_v3,exp_v3_001011,2024.00,3.00,1.00,False,False,False,True,40
Jordyn,2024-03-23,Wells Fargo,Whole Foods,,24.33,24.33,,,,24.33,24.33,0.00,simple,False,,expense_history_csv,Consolidated_Expense_History_20250622.csv,2025-07-18T12:32:53.413399,3.0,advanced_calculations_v3,exp_v3_001012,2024.00,3.00,1.00,False,False,False,True,40
Jordyn,2024-03-23,Wells Fargo,Total Wine,,33.07,33.07,,,,33.07,33.07,0.00,simple,False,,expense_history_csv,Consolidated_Expense_History_20250622.csv,2025-07-18T12:32:53.413399,3.0,advanced_calculations_v3,exp_v3_001013,2024.00,3.00,1.00,False,False,False,True,40
Jordyn,2024-03-23,Wells Fargo,Dave & Busters,,24.06,24.06,,,,24.06,24.06,0.00,simple,False,,expense_history_csv,Consolidated_Expense_History_20250622.csv,2025-07-18T12:32:53.413399,3.0,advanced_calculations_v3,exp_v3_001014,2024.00,3.00,1.00,False,False,False,True,40
Jordyn,2024-03-24,Wells Fargo,Zinburger,,38.98,38.98,,,,38.98,38.98,0.00,simple,False,,expense_history_csv,Consolidated_Expense_History_20250622.csv,2025-07-18T12:32:53.413399,3.0,advanced_calculations_v3,exp_v3_001015,2024.00,3.00,1.00,False,False,False,True,40
Jordyn,2024-03-25,Wells Fargo,Amazon,,65.91,65.91,"Rabbit Automatic Electric Corkscrew Wine Bottle Opener, Burt's Bees, etc.",,,65.91,65.91,0.00,simple,False,,expense_history_csv,Consolidated_Expense_History_20250622.csv,2025-07-18T12:32:53.413399,3.0,advanced_calculations_v3,exp_v3_001016,2024.00,3.00,1.00,False,False,False,True,60
Jordyn,2024-03-25,Wells Fargo,Sprout's,,24.80,24.80,,,,24.80,24.80,0.00,simple,False,,expense_history_csv,Consolidated_Expense_History_20250622.csv,2025-07-18T12:32:53.413399,3.0,advanced_calculations_v3,exp_v3_001017,2024.00,3.00,1.00,False,False,False,True,40
Jordyn,2024-03-26,Wells Fargo,Fry's,,135.76,135.76,,,,135.76,135.76,0.00,simple,False,,expense_history_csv,Consolidated_Expense_History_20250622.csv,2025-07-18T12:32:53.413399,3.0,advanced_calculations_v3,exp_v3_001018,2024.00,3.00,1.00,False,False,False,True,40
Jordyn,2024-03-28,Wells Fargo,Blue Wasabi,,48.77,48.77,,,,48.77,48.77,0.00,simple,False,,expense_history_csv,Consolidated_Expense_History_20250622.csv,2025-07-18T12:32:53.413399,3.0,advanced_calculations_v3,exp_v3_001019,2024.00,3.00,1.00,False,False,False,True,40
Jordyn,2024-03-29,Wells Fargo,Amazon,,21.19,21.19,"Longzon 4-in-1 Knife Sharpener, Mercer Culinary Knife Guard",,,21.19,21.19,0.00,simple,False,,expense_history_csv,Consolidated_Expense_History_20250622.csv,2025-07-18T12:32:53.413399,3.0,advanced_calculations_v3,exp_v3_001020,2024.00,3.00,1.00,False,False,False,True,60
Jordyn,2024-03-29,Wells Fargo,AMF,,25.62,25.62,,,,25.62,25.62,0.00,simple,False,,expense_history_csv,Consolidated_Expense_History_20250622.csv,2025-07-18T12:32:53.413399,3.0,advanced_calculations_v3,exp_v3_001021,2024.00,3.00,1.00,False,False,False,True,40
Jordyn,2024-03-30,Wells Fargo,Thirsty Lion,,40.43,40.43,,,,40.43,40.43,0.00,simple,False,,expense_history_csv,Consolidated_Expense_History_20250622.csv,2025-07-18T12:32:53.413399,3.0,advanced_calculations_v3,exp_v3_001022,2024.00,3.00,1.00,False,False,False,True,40
Jordyn,2024-03-30,Wells Fargo,BJ's Restaurant,,67.73,67.73,,,,67.73,67.73,0.00,simple,False,,expense_history_csv,Consolidated_Expense_History_20250622.csv,2025-07-18T12:32:53.413399,3.0,advanced_calculations_v3,exp_v3_001023,2024.00,3.00,1.00,False,False,False,True,40
Jordyn,2024-03-30,Wells Fargo,Sprouts,,27.47,27.47,,,,27.47,27.47,0.00,simple,False,,expense_history_csv,Consolidated_Expense_History_20250622.csv,2025-07-18T12:32:53.413399,3.0,advanced_calculations_v3,exp_v3_001024,2024.00,3.00,1.00,False,False,False,True,40
Jordyn,2024-04-01,Wells Fargo,Amazon,,21.55,21.55,Neurodiversity T-Shirt,,,21.55,21.55,0.00,simple,False,,expense_history_csv,Consolidated_Expense_History_20250622.csv,2025-07-18T12:32:53.413399,3.0,advanced_calculations_v3,exp_v3_001025,2024.00,4.00,2.00,False,False,False,True,60
Jordyn,2024-04-02,Wells Fargo,Amazon,,12.60,12.60,OMOTON Adjustsable Table STand for Desk (Kindle),,,12.60,12.60,1.00,simple,False,Mathematical operation: (Kindle),expense_history_csv,Consolidated_Expense_History_20250622.csv,2025-07-18T12:32:53.413399,3.0,advanced_calculations_v3,exp_v3_001026,2024.00,4.00,2.00,False,False,False,True,60
Jordyn,2024-04-02,Wells Fargo,Fry's,,91.74,91.74,,,,91.74,91.74,0.00,simple,False,,expense_history_csv,Consolidated_Expense_History_20250622.csv,2025-07-18T12:32:53.413399,3.0,advanced_calculations_v3,exp_v3_001027,2024.00,4.00,2.00,False,False,False,True,40
Jordyn,2024-04-05,Wells Fargo,The Hub,,35.89,35.89,,,,35.89,35.89,0.00,simple,False,,expense_history_csv,Consolidated_Expense_History_20250622.csv,2025-07-18T12:32:53.413399,3.0,advanced_calculations_v3,exp_v3_001028,2024.00,4.00,2.00,False,False,False,True,40
Jordyn,2024-04-06,Wells Fargo,La Ristra,,52.51,52.51,,,,52.51,52.51,0.00,simple,False,,expense_history_csv,Consolidated_Expense_History_20250622.csv,2025-07-18T12:32:53.413399,3.0,advanced_calculations_v3,exp_v3_001029,2024.00,4.00,2.00,False,False,False,True,40
Jordyn,2024-04-06,Wells Fargo,Amazon,,8.60,8.60,Butterfly Coloring Book,,,8.60,8.60,0.00,simple,False,,expense_history_csv,Consolidated_Expense_History_20250622.csv,2025-07-18T12:32:53.413399,3.0,advanced_calculations_v3,exp_v3_001030,2024.00,4.00,2.00,False,False,False,True,60
Jordyn,2024-04-06,Wells Fargo,Sister's Addict (Lamps),,77.57,77.57,,,,77.57,77.57,0.00,simple,False,,expense_history_csv,Consolidated_Expense_History_20250622.csv,2025-07-18T12:32:53.413399,3.0,advanced_calculations_v3,exp_v3_001031,2024.00,4.00,2.00,False,False,False,True,40
Jordyn,2024-04-06,Wells Fargo,Whole Foods,,18.52,18.52,,,,18.52,18.52,0.00,simple,False,,expense_history_csv,Consolidated_Expense_History_20250622.csv,2025-07-18T12:32:53.413399,3.0,advanced_calculations_v3,exp_v3_001032,2024.00,4.00,2.00,False,False,False,True,40
Jordyn,2024-04-08,Wells Fargo,Fry's,,169.25,169.25,,,,169.25,169.25,0.00,simple,False,,expense_history_csv,Consolidated_Expense_History_20250622.csv,2025-07-18T12:32:53.413399,3.0,advanced_calculations_v3,exp_v3_001033,2024.00,4.00,2.00,False,False,False,True,40
Jordyn,2024-04-09,Wells Fargo,Amazon,,25.92,25.92,"CASEKOO for iPhone 13 Pro Case, Miracle-Gro",,,25.92,25.92,0.00,simple,False,,expense_history_csv,Consolidated_Expense_History_20250622.csv,2025-07-18T12:32:53.413399,3.0,advanced_calculations_v3,exp_v3_001034,2024.00,4.00,2.00,False,False,False,True,60
Jordyn,2024-04-12,Wells Fargo,Target,,48.51,48.51,,,,48.51,48.51,0.00,simple,False,,expense_history_csv,Consolidated_Expense_History_20250622.csv,2025-07-18T12:32:53.413399,3.0,advanced_calculations_v3,exp_v3_001035,2024.00,4.00,2.00,False,False,False,True,40
Jordyn,2024-04-14,Wells Fargo,Sprouts,,47.98,47.98,,,,47.98,47.98,0.00,simple,False,,expense_history_csv,Consolidated_Expense_History_20250622.csv,2025-07-18T12:32:53.413399,3.0,advanced_calculations_v3,exp_v3_001036,2024.00,4.00,2.00,False,False,False,True,40
Jordyn,2024-04-14,Wells Fargo,Taste of China,,48.39,48.39,,,,48.39,48.39,0.00,simple,False,,expense_history_csv,Consolidated_Expense_History_20250622.csv,2025-07-18T12:32:53.413399,3.0,advanced_calculations_v3,exp_v3_001037,2024.00,4.00,2.00,False,False,False,True,40
Jordyn,2024-04-16,Wells Fargo,Amazon,,114.34,,"Hand Grip Set, Grip Strength Trainer, etc (Ryan 100%) - ADD TO FINAL",,,114.34,,3.00,gift_present,False,Contains percentage allocation: Ryan 100%; Gift/present allocation: Ryan 100%; Mathematical operation: (Ryan 100%),expense_history_csv,Consolidated_Expense_History_20250622.csv,2025-07-18T12:32:53.413399,3.0,advanced_calculations_v3,exp_v3_001038,2024.00,4.00,2.00,True,True,False,True,40
Jordyn,2024-04-16,Wells Fargo,Amazon,,10.77,,Vitamin K (Ryan 100%) - ADD TO FINAL,,,10.77,,3.00,gift_present,False,Contains percentage allocation: Ryan 100%; Gift/present allocation: Ryan 100%; Mathematical operation: (Ryan 100%),expense_history_csv,Consolidated_Expense_History_20250622.csv,2025-07-18T12:32:53.413399,3.0,advanced_calculations_v3,exp_v3_001039,2024.00,4.00,2.00,True,True,False,True,40
Jordyn,2024-04-19,,Brewing - Gilbert,,11.80,11.80,,,,11.80,11.80,0.00,simple,False,,expense_history_csv,Consolidated_Expense_History_20250622.csv,2025-07-18T12:32:53.413399,3.0,advanced_calculations_v3,exp_v3_001040,2024.00,4.00,2.00,False,False,False,True,40
Jordyn,2024-04-19,,Sprout's,,17.59,17.59,,,,17.59,17.59,0.00,simple,False,,expense_history_csv,Consolidated_Expense_History_20250622.csv,2025-07-18T12:32:53.413399,3.0,advanced_calculations_v3,exp_v3_001041,2024.00,4.00,2.00,False,False,False,True,40
Jordyn,2024-04-23,,Fry's,,38.51,38.51,,,,38.51,38.51,0.00,simple,False,,expense_history_csv,Consolidated_Expense_History_20250622.csv,2025-07-18T12:32:53.413399,3.0,advanced_calculations_v3,exp_v3_001042,2024.00,4.00,2.00,False,False,False,True,40
Jordyn,2024-04-26,,The Hub,,34.36,34.36,,,,34.36,34.36,0.00,simple,False,,expense_history_csv,Consolidated_Expense_History_20250622.csv,2025-07-18T12:32:53.413399,3.0,advanced_calculations_v3,exp_v3_001043,2024.00,4.00,2.00,False,False,False,True,40
Jordyn,2024-04-28,,Endgame,,7.50,7.50,,,,7.50,7.50,0.00,simple,False,,expense_history_csv,Consolidated_Expense_History_20250622.csv,2025-07-18T12:32:53.413399,3.0,advanced_calculations_v3,exp_v3_001044,2024.00,4.00,2.00,False,False,False,True,40
Jordyn,2024-04-28,,Endgame,,6.50,6.50,,,,6.50,6.50,0.00,simple,False,,expense_history_csv,Consolidated_Expense_History_20250622.csv,2025-07-18T12:32:53.413399,3.0,advanced_calculations_v3,exp_v3_001045,2024.00,4.00,2.00,False,False,False,True,40
Jordyn,2024-04-28,,Uber,,10.67,10.67,,,,10.67,10.67,0.00,simple,False,,expense_history_csv,Consolidated_Expense_History_20250622.csv,2025-07-18T12:32:53.413399,3.0,advanced_calculations_v3,exp_v3_001046,2024.00,4.00,2.00,False,False,False,True,40
Jordyn,2024-04-28,,Lowes - Chandler,,128.00,,Flowers / Paid by Zelle,,,128.00,,0.00,simple,False,,expense_history_csv,Consolidated_Expense_History_20250622.csv,2025-07-18T12:32:53.413399,3.0,advanced_calculations_v3,exp_v3_001047,2024.00,4.00,2.00,False,False,False,True,40
Jordyn,2024-04-30,,Target,,20.59,20.59,,,,20.59,20.59,0.00,simple,False,,expense_history_csv,Consolidated_Expense_History_20250622.csv,2025-07-18T12:32:53.413399,3.0,advanced_calculations_v3,exp_v3_001048,2024.00,4.00,2.00,False,False,False,True,40
Jordyn,2024-04-30,,Target,,2.62,2.62,,,,2.62,2.62,0.00,simple,False,,expense_history_csv,Consolidated_Expense_History_20250622.csv,2025-07-18T12:32:53.413399,3.0,advanced_calculations_v3,exp_v3_001049,2024.00,4.00,2.00,False,False,False,True,40
Jordyn,2024-04-30,,Target,,3.22,3.22,,,,3.22,3.22,0.00,simple,False,,expense_history_csv,Consolidated_Expense_History_20250622.csv,2025-07-18T12:32:53.413399,3.0,advanced_calculations_v3,exp_v3_001050,2024.00,4.00,2.00,False,False,False,True,40
Jordyn,2024-05-02,,Amazon,,9.89,9.89,Pocket Hug Token Long Distance Relationship Keepsake Stainless Steel Double Sided Inspirational Gift with PU Leather Keychain (Sobriety),,,9.89,9.89,1.00,simple,False,Mathematical operation: (Sobriety),expense_history_csv,Consolidated_Expense_History_20250622.csv,2025-07-18T12:32:53.413399,3.0,advanced_calculations_v3,exp_v3_001051,2024.00,5.00,2.00,False,False,False,True,60
Jordyn,2024-05-03,,Cooper's Hawk,,49.72,49.72,,,,49.72,49.72,0.00,simple,False,,expense_history_csv,Consolidated_Expense_History_20250622.csv,2025-07-18T12:32:53.413399,3.0,advanced_calculations_v3,exp_v3_001052,2024.00,5.00,2.00,False,False,False,True,40
Jordyn,2024-05-03,,Fry's,,27.39,27.39,,,,27.39,27.39,0.00,simple,False,,expense_history_csv,Consolidated_Expense_History_20250622.csv,2025-07-18T12:32:53.413399,3.0,advanced_calculations_v3,exp_v3_001053,2024.00,5.00,2.00,False,False,False,True,40
Jordyn,2024-05-04,,Whole Foods,,16.13,16.13,,,,16.13,16.13,0.00,simple,False,,expense_history_csv,Consolidated_Expense_History_20250622.csv,2025-07-18T12:32:53.413399,3.0,advanced_calculations_v3,exp_v3_001054,2024.00,5.00,2.00,False,False,False,True,40
Jordyn,2024-05-04,,Whole Foods,,9.73,9.73,,,,9.73,9.73,0.00,simple,False,,expense_history_csv,Consolidated_Expense_History_20250622.csv,2025-07-18T12:32:53.413399,3.0,advanced_calculations_v3,exp_v3_001055,2024.00,5.00,2.00,False,False,False,True,40
Jordyn,2024-05-04,,Whole Foods,,16.22,16.22,,,,16.22,16.22,0.00,simple,False,,expense_history_csv,Consolidated_Expense_History_20250622.csv,2025-07-18T12:32:53.413399,3.0,advanced_calculations_v3,exp_v3_001056,2024.00,5.00,2.00,False,False,False,True,40
Jordyn,2024-05-05,,Amazon,,24.13,24.13,"Under Armour Men's Training Stretch Shorts , Pitch Gray (012)/Black , Large",,,24.13,24.13,1.00,simple,False,Mathematical operation: (012),expense_history_csv,Consolidated_Expense_History_20250622.csv,2025-07-18T12:32:53.413399,3.0,advanced_calculations_v3,exp_v3_001057,2024.00,5.00,2.00,False,False,False,True,60
Jordyn,2024-05-06,,Fry's,,13.98,13.98,,,,13.98,13.98,0.00,simple,False,,expense_history_csv,Consolidated_Expense_History_20250622.csv,2025-07-18T12:32:53.413399,3.0,advanced_calculations_v3,exp_v3_001058,2024.00,5.00,2.00,False,False,False,True,40
Jordyn,2024-05-06,,Blizzard,,96.38,96.38,Diablo 4,,,96.38,96.38,0.00,simple,False,,expense_history_csv,Consolidated_Expense_History_20250622.csv,2025-07-18T12:32:53.413399,3.0,advanced_calculations_v3,exp_v3_001059,2024.00,5.00,2.00,False,False,False,True,60
Jordyn,2024-05-08,,Sprout's,,40.09,40.09,,,,40.09,40.09,0.00,simple,False,,expense_history_csv,Consolidated_Expense_History_20250622.csv,2025-07-18T12:32:53.413399,3.0,advanced_calculations_v3,exp_v3_001060,2024.00,5.00,2.00,False,False,False,True,40
Jordyn,2024-05-11,,Snooze,,59.35,59.35,,,,59.35,59.35,0.00,simple,False,,expense_history_csv,Consolidated_Expense_History_20250622.csv,2025-07-18T12:32:53.413399,3.0,advanced_calculations_v3,exp_v3_001061,2024.00,5.00,2.00,False,False,False,True,40
Jordyn,2024-05-11,,Fry's,,56.68,56.68,,,,56.68,56.68,0.00,simple,False,,expense_history_csv,Consolidated_Expense_History_20250622.csv,2025-07-18T12:32:53.413399,3.0,advanced_calculations_v3,exp_v3_001062,2024.00,5.00,2.00,False,False,False,True,40
Jordyn,2024-05-11,,The Hub,,35.03,35.03,,,,35.03,35.03,0.00,simple,False,,expense_history_csv,Consolidated_Expense_History_20250622.csv,2025-07-18T12:32:53.413399,3.0,advanced_calculations_v3,exp_v3_001063,2024.00,5.00,2.00,False,False,False,True,40
Jordyn,2024-05-12,,Farm & Craft,,83.15,83.15,,,,83.15,83.15,0.00,simple,False,,expense_history_csv,Consolidated_Expense_History_20250622.csv,2025-07-18T12:32:53.413399,3.0,advanced_calculations_v3,exp_v3_001064,2024.00,5.00,2.00,False,False,False,True,40
Jordyn,2024-05-14,,Fry's,,77.00,77.00,,,,77.00,77.00,0.00,simple,False,,expense_history_csv,Consolidated_Expense_History_20250622.csv,2025-07-18T12:32:53.413399,3.0,advanced_calculations_v3,exp_v3_001065,2024.00,5.00,2.00,False,False,False,True,40
Jordyn,2024-05-15,,Fry's,,19.26,19.26,,,,19.26,19.26,0.00,simple,False,,expense_history_csv,Consolidated_Expense_History_20250622.csv,2025-07-18T12:32:53.413399,3.0,advanced_calculations_v3,exp_v3_001066,2024.00,5.00,2.00,False,False,False,True,40
Jordyn,2024-05-18,,Seat Geeks,,75.08,75.08,"Daughtry (Opener), Finger 11",,,75.08,75.08,1.00,simple,False,Mathematical operation: (Opener),expense_history_csv,Consolidated_Expense_History_20250622.csv,2025-07-18T12:32:53.413399,3.0,advanced_calculations_v3,exp_v3_001067,2024.00,5.00,2.00,False,False,False,True,60
Jordyn,2024-05-18,,SP The Collective Mark,,50.65,50.65,,,,50.65,50.65,0.00,simple,False,,expense_history_csv,Consolidated_Expense_History_20250622.csv,2025-07-18T12:32:53.413399,3.0,advanced_calculations_v3,exp_v3_001068,2024.00,5.00,2.00,False,False,False,True,40
Jordyn,2024-05-18,,Picazzo's,,43.21,43.21,,,,43.21,43.21,0.00,simple,False,,expense_history_csv,Consolidated_Expense_History_20250622.csv,2025-07-18T12:32:53.413399,3.0,advanced_calculations_v3,exp_v3_001069,2024.00,5.00,2.00,False,False,False,True,40
Jordyn,2024-05-18,,Fry's,,51.70,51.70,,,,51.70,51.70,0.00,simple,False,,expense_history_csv,Consolidated_Expense_History_20250622.csv,2025-07-18T12:32:53.413399,3.0,advanced_calculations_v3,exp_v3_001070,2024.00,5.00,2.00,False,False,False,True,40
Jordyn,2024-05-19,,OSHO,,71.57,71.57,,,,71.57,71.57,0.00,simple,False,,expense_history_csv,Consolidated_Expense_History_20250622.csv,2025-07-18T12:32:53.413399,3.0,advanced_calculations_v3,exp_v3_001071,2024.00,5.00,2.00,False,False,False,True,40
Jordyn,2024-05-19,,OSHO,,7.47,7.47,,,,7.47,7.47,0.00,simple,False,,expense_history_csv,Consolidated_Expense_History_20250622.csv,2025-07-18T12:32:53.413399,3.0,advanced_calculations_v3,exp_v3_001072,2024.00,5.00,2.00,False,False,False,True,40
Jordyn,2024-05-21,,Amazon,,28.41,28.41,"Boiron Arnicare Bruise Cream for Pain Relief from Bruising and Swelling or Discoloration from Injury - 1.4 oz(Pack of 1) & Chomps Snack Size Grass-Fed and Finished Sea Salt Beef Jerky Snack Sticks 0.5oz 24-Pack - Keto, Paleo, Whole30, 4g Lean Meat Protein, Gluten-Free, Zer",,,28.41,28.41,1.00,simple,False,Mathematical operation: (Pack of 1),expense_history_csv,Consolidated_Expense_History_20250622.csv,2025-07-18T12:32:53.413399,3.0,advanced_calculations_v3,exp_v3_001073,2024.00,5.00,2.00,False,False,False,True,60
Jordyn,2024-05-21,,Taste of China,,43.58,43.58,,,,43.58,43.58,0.00,simple,False,,expense_history_csv,Consolidated_Expense_History_20250622.csv,2025-07-18T12:32:53.413399,3.0,advanced_calculations_v3,exp_v3_001074,2024.00,5.00,2.00,False,False,False,True,40
Jordyn,2024-05-23,,Sprout's,,47.30,47.30,,,,47.30,47.30,0.00,simple,False,,expense_history_csv,Consolidated_Expense_History_20250622.csv,2025-07-18T12:32:53.413399,3.0,advanced_calculations_v3,exp_v3_001075,2024.00,5.00,2.00,False,False,False,True,40
Jordyn,2024-05-23,,Fry's,,289.99,289.99,,,,289.99,289.99,0.00,simple,False,,expense_history_csv,Consolidated_Expense_History_20250622.csv,2025-07-18T12:32:53.413399,3.0,advanced_calculations_v3,exp_v3_001076,2024.00,5.00,2.00,False,False,False,True,40
Jordyn,2024-05-24,,Espo's,,35.64,35.64,,,,35.64,35.64,0.00,simple,False,,expense_history_csv,Consolidated_Expense_History_20250622.csv,2025-07-18T12:32:53.413399,3.0,advanced_calculations_v3,exp_v3_001077,2024.00,5.00,2.00,False,False,False,True,40
Jordyn,2024-05-24,,Espo's,,4.33,4.33,,,,4.33,4.33,0.00,simple,False,,expense_history_csv,Consolidated_Expense_History_20250622.csv,2025-07-18T12:32:53.413399,3.0,advanced_calculations_v3,exp_v3_001078,2024.00,5.00,2.00,False,False,False,True,40
Jordyn,2024-05-24,,Amazon,,12.93,12.93,What Should Danny Do? (The Power to Choose Series),,,12.93,12.93,1.00,simple,False,Mathematical operation: (The Power to Choose Series),expense_history_csv,Consolidated_Expense_History_20250622.csv,2025-07-18T12:32:53.413399,3.0,advanced_calculations_v3,exp_v3_001079,2024.00,5.00,2.00,False,False,False,True,60
Jordyn,2024-05-26,,Whole Foods,,13.89,13.89,,,,13.89,13.89,0.00,simple,False,,expense_history_csv,Consolidated_Expense_History_20250622.csv,2025-07-18T12:32:53.413399,3.0,advanced_calculations_v3,exp_v3_001080,2024.00,5.00,2.00,False,False,False,True,40
Jordyn,2024-05-27,,The Hub,,34.22,34.22,,,,34.22,34.22,0.00,simple,False,,expense_history_csv,Consolidated_Expense_History_20250622.csv,2025-07-18T12:32:53.413399,3.0,advanced_calculations_v3,exp_v3_001081,2024.00,5.00,2.00,False,False,False,True,40
Jordyn,2024-05-27,,In & Out,,18.65,18.65,,,,18.65,18.65,0.00,simple,False,,expense_history_csv,Consolidated_Expense_History_20250622.csv,2025-07-18T12:32:53.413399,3.0,advanced_calculations_v3,exp_v3_001082,2024.00,5.00,2.00,False,False,False,True,40
Jordyn,2024-05-28,,Taco Chiuahs,,19.46,19.46,,,,19.46,19.46,0.00,simple,False,,expense_history_csv,Consolidated_Expense_History_20250622.csv,2025-07-18T12:32:53.413399,3.0,advanced_calculations_v3,exp_v3_001083,2024.00,5.00,2.00,False,False,False,True,40
Jordyn,2024-05-29,,Fry's,,26.45,26.45,,,,26.45,26.45,0.00,simple,False,,expense_history_csv,Consolidated_Expense_History_20250622.csv,2025-07-18T12:32:53.413399,3.0,advanced_calculations_v3,exp_v3_001084,2024.00,5.00,2.00,False,False,False,True,40
Jordyn,2024-05-31,,Fry's,,26.23,26.23,,,,26.23,26.23,0.00,simple,False,,expense_history_csv,Consolidated_Expense_History_20250622.csv,2025-07-18T12:32:53.413399,3.0,advanced_calculations_v3,exp_v3_001085,2024.00,5.00,2.00,False,False,False,True,40
Jordyn,2024-05-31,,Amazon,,35.03,35.03,"Orville Redenbacher's Original Gourmet Popping Corn Kernels, 8 lb. & DASH Hot Air Popcorn Popper Maker with Measuring Cup to Portion Popping Corn Kernels + Melt Butter, 16 Cups - Aqua",,,35.03,35.03,0.00,simple,False,,expense_history_csv,Consolidated_Expense_History_20250622.csv,2025-07-18T12:32:53.413399,3.0,advanced_calculations_v3,exp_v3_001086,2024.00,5.00,2.00,False,False,False,True,60
Jordyn,2024-06-02,,Sprout's,,62.24,62.24,,,,62.24,62.24,0.00,simple,False,,expense_history_csv,Consolidated_Expense_History_20250622.csv,2025-07-18T12:32:53.413399,3.0,advanced_calculations_v3,exp_v3_001087,2024.00,6.00,2.00,False,False,False,True,40
Jordyn,2024-06-05,,Fry's,,34.75,34.75,,,,34.75,34.75,0.00,simple,False,,expense_history_csv,Consolidated_Expense_History_20250622.csv,2025-07-18T12:32:53.413399,3.0,advanced_calculations_v3,exp_v3_001088,2024.00,6.00,2.00,False,False,False,True,40
Jordyn,2024-06-06,,Amazon,,25.86,,"Physician's CHOICE Probiotics 60 Billion CFU - 10 Strains + Organic Prebiotics - Immune, Digestive & Gut Health - Supports Occasional Constipation, Diarrhea, Gas & Bloating - for Women & Men - 60ct",,,25.86,,0.00,simple,False,,expense_history_csv,Consolidated_Expense_History_20250622.csv,2025-07-18T12:32:53.413399,3.0,advanced_calculations_v3,exp_v3_001089,2024.00,6.00,2.00,False,False,False,True,40
Jordyn,2024-06-07,,Whole Foods,,47.89,47.89,,,,47.89,47.89,0.00,simple,False,,expense_history_csv,Consolidated_Expense_History_20250622.csv,2025-07-18T12:32:53.413399,3.0,advanced_calculations_v3,exp_v3_001090,2024.00,6.00,2.00,False,False,False,True,40
Jordyn,2024-06-08,,Cooper's Hawk,,93.00,93.00,,,,93.00,93.00,0.00,simple,False,,expense_history_csv,Consolidated_Expense_History_20250622.csv,2025-07-18T12:32:53.413399,3.0,advanced_calculations_v3,exp_v3_001091,2024.00,6.00,2.00,False,False,False,True,40
Jordyn,2024-06-14,,Amazon,,9.12,9.12,"Mantova Ghee Oil, 100% Pure Cooking Oil Spray, Omega-3, perfect for Keto snacks, baking, grilling, or cooking, our oil dispenser bottle lets you spray, drip, or stream with no waste, 5 oz",,,9.12,9.12,0.00,simple,False,,expense_history_csv,Consolidated_Expense_History_20250622.csv,2025-07-18T12:32:53.413399,3.0,advanced_calculations_v3,exp_v3_001092,2024.00,6.00,2.00,False,False,False,True,60
Jordyn,2024-06-15,,Chon Thai,,31.85,31.85,,,,31.85,31.85,0.00,simple,False,,expense_history_csv,Consolidated_Expense_History_20250622.csv,2025-07-18T12:32:53.413399,3.0,advanced_calculations_v3,exp_v3_001093,2024.00,6.00,2.00,False,False,False,True,40
Jordyn,2024-06-15,,Snooze,,61.58,61.58,,,,61.58,61.58,0.00,simple,False,,expense_history_csv,Consolidated_Expense_History_20250622.csv,2025-07-18T12:32:53.413399,3.0,advanced_calculations_v3,exp_v3_001094,2024.00,6.00,2.00,False,False,False,True,40
Jordyn,2024-06-15,,Amazon,,43.11,,Florensi Meditation Cushion - Comfortable Floor Pillow - Traditional Crescent Meditation Pillow with Beautiful Velvet Cover - Large Floor Cushion Seating for Adults - Premium Yoga Buckwheat Bolster,,,43.11,,0.00,simple,False,,expense_history_csv,Consolidated_Expense_History_20250622.csv,2025-07-18T12:32:53.413399,3.0,advanced_calculations_v3,exp_v3_001095,2024.00,6.00,2.00,False,False,False,True,40
Jordyn,2024-06-15,,Amazon,,14.54,14.54,"WIBIMEN Grill Mats for Ourdoor Grill, Set of 7 Copper Grill Mat 100% PFOA Free Non-Stick 15.75 x 13"", Heavy Duty, Resuable and Easy to Clean, Works on Gas Charcoal and Electric BBQ (7pcs) (Copper)",,,14.54,14.54,2.00,simple,False,Mathematical operation: (7pcs); Mathematical operation: (Copper),expense_history_csv,Consolidated_Expense_History_20250622.csv,2025-07-18T12:32:53.413399,3.0,advanced_calculations_v3,exp_v3_001096,2024.00,6.00,2.00,False,False,False,True,60
Jordyn,2024-06-15,,Amazon,,25.33,,"Gifts for Dad, Dad Gifts from Daughter Son, Fathers Day Birthday Gifts for Dad Grandpa, Gifts for Dad Who Wants Nothing, Soy Candle, Long Burning & Highly Scented & Bommex Dear Dad We Hope Every Time You Hug This Pillow It Reminds You How Much We Love You Throw Pillow Cover Cushion Case Dad Gift Reminder Gift Birthday Gift (dad-we)",,,25.33,,1.00,simple,False,Mathematical operation: (dad-we),expense_history_csv,Consolidated_Expense_History_20250622.csv,2025-07-18T12:32:53.413399,3.0,advanced_calculations_v3,exp_v3_001097,2024.00,6.00,2.00,False,False,False,True,40
Jordyn,2024-06-16,,Uber,,7.47,7.47,,,,7.47,7.47,0.00,simple,False,,expense_history_csv,Consolidated_Expense_History_20250622.csv,2025-07-18T12:32:53.413399,3.0,advanced_calculations_v3,exp_v3_001098,2024.00,6.00,2.00,False,False,False,True,40
Jordyn,2024-06-18,,Fry's,,95.98,95.98,,,,95.98,95.98,0.00,simple,False,,expense_history_csv,Consolidated_Expense_History_20250622.csv,2025-07-18T12:32:53.413399,3.0,advanced_calculations_v3,exp_v3_001099,2024.00,6.00,2.00,False,False,False,True,40
Jordyn,2024-06-20,,Amazon,,23.73,,Glutenase & Shampoo,,,23.73,,0.00,simple,False,,expense_history_csv,Consolidated_Expense_History_20250622.csv,2025-07-18T12:32:53.413399,3.0,advanced_calculations_v3,exp_v3_001100,2024.00,6.00,2.00,False,False,False,True,40
Jordyn,2024-06-21,,IKEA,,73.42,73.42,,,,73.42,73.42,0.00,simple,False,,expense_history_csv,Consolidated_Expense_History_20250622.csv,2025-07-18T12:32:53.413399,3.0,advanced_calculations_v3,exp_v3_001101,2024.00,6.00,2.00,False,False,False,True,40
Jordyn,2024-06-21,,Island Fin Poke,,32.36,32.36,,,,32.36,32.36,0.00,simple,False,,expense_history_csv,Consolidated_Expense_History_20250622.csv,2025-07-18T12:32:53.413399,3.0,advanced_calculations_v3,exp_v3_001102,2024.00,6.00,2.00,False,False,False,True,40
Jordyn,2024-06-23,,Rebel Wine Lounge,,24.57,24.57,,,,24.57,24.57,0.00,simple,False,,expense_history_csv,Consolidated_Expense_History_20250622.csv,2025-07-18T12:32:53.413399,3.0,advanced_calculations_v3,exp_v3_001103,2024.00,6.00,2.00,False,False,False,True,40
Jordyn,2024-06-23,,The Hub,,81.10,81.10,,,,81.10,81.10,0.00,simple,False,,expense_history_csv,Consolidated_Expense_History_20250622.csv,2025-07-18T12:32:53.413399,3.0,advanced_calculations_v3,exp_v3_001104,2024.00,6.00,2.00,False,False,False,True,40
Jordyn,2024-06-25,,Fry's,,224.66,224.66,,,,224.66,224.66,0.00,simple,False,,expense_history_csv,Consolidated_Expense_History_20250622.csv,2025-07-18T12:32:53.413399,3.0,advanced_calculations_v3,exp_v3_001105,2024.00,6.00,2.00,False,False,False,True,40
Jordyn,2024-06-26,,Whole Foods,,25.94,25.94,,,,25.94,25.94,0.00,simple,False,,expense_history_csv,Consolidated_Expense_History_20250622.csv,2025-07-18T12:32:53.413399,3.0,advanced_calculations_v3,exp_v3_001106,2024.00,6.00,2.00,False,False,False,True,40
Jordyn,2024-06-26,,Amazon,,31.83,31.83,Preg Test & L-lysine,,,31.83,31.83,0.00,simple,False,,expense_history_csv,Consolidated_Expense_History_20250622.csv,2025-07-18T12:32:53.413399,3.0,advanced_calculations_v3,exp_v3_001107,2024.00,6.00,2.00,False,False,False,True,60
Jordyn,2024-06-27,,Gu's Fried Chicken,,62.60,62.60,,,,62.60,62.60,0.00,simple,False,,expense_history_csv,Consolidated_Expense_History_20250622.csv,2025-07-18T12:32:53.413399,3.0,advanced_calculations_v3,exp_v3_001108,2024.00,6.00,2.00,False,False,False,True,40
Jordyn,2024-06-27,,Sprout's,,31.11,31.11,,,,31.11,31.11,0.00,simple,False,,expense_history_csv,Consolidated_Expense_History_20250622.csv,2025-07-18T12:32:53.413399,3.0,advanced_calculations_v3,exp_v3_001109,2024.00,6.00,2.00,False,False,False,True,40
Jordyn,2024-06-30,,Home Goods,,35.81,35.81,,,,35.81,35.81,0.00,simple,False,,expense_history_csv,Consolidated_Expense_History_20250622.csv,2025-07-18T12:32:53.413399,3.0,advanced_calculations_v3,exp_v3_001110,2024.00,6.00,2.00,False,False,False,True,40
Jordyn,2024-06-30,,Amazon,,39.56,39.56,Ollie (aka Prince Ali!),,,39.56,39.56,1.00,simple,False,Mathematical operation: (aka Prince Ali!),expense_history_csv,Consolidated_Expense_History_20250622.csv,2025-07-18T12:32:53.413399,3.0,advanced_calculations_v3,exp_v3_001111,2024.00,6.00,2.00,False,False,False,True,60
Jordyn,2024-07-01,,Amazon,,34.48,34.48,Ollie (aka Prince Ali!),,,34.48,34.48,1.00,simple,False,Mathematical operation: (aka Prince Ali!),expense_history_csv,Consolidated_Expense_History_20250622.csv,2025-07-18T12:32:53.413399,3.0,advanced_calculations_v3,exp_v3_001112,2024.00,7.00,3.00,False,False,False,True,60
Jordyn,2024-07-01,,Amazon,,57.53,57.53,Ollie (aka Prince Ali!),,,57.53,57.53,1.00,simple,False,Mathematical operation: (aka Prince Ali!),expense_history_csv,Consolidated_Expense_History_20250622.csv,2025-07-18T12:32:53.413399,3.0,advanced_calculations_v3,exp_v3_001113,2024.00,7.00,3.00,False,False,False,True,60
Jordyn,2024-07-01,,Amazon,,9.69,9.69,Ollie (aka Prince Ali!),,,9.69,9.69,1.00,simple,False,Mathematical operation: (aka Prince Ali!),expense_history_csv,Consolidated_Expense_History_20250622.csv,2025-07-18T12:32:53.413399,3.0,advanced_calculations_v3,exp_v3_001114,2024.00,7.00,3.00,False,False,False,True,60
Jordyn,2024-07-03,,Amazon,,10.72,10.72,Ollie (aka Prince Ali!),,,10.72,10.72,1.00,simple,False,Mathematical operation: (aka Prince Ali!),expense_history_csv,Consolidated_Expense_History_20250622.csv,2025-07-18T12:32:53.413399,3.0,advanced_calculations_v3,exp_v3_001115,2024.00,7.00,3.00,False,False,False,True,60
Jordyn,2024-07-03,,PetMarket,,130.91,130.91,,,,130.91,130.91,0.00,simple,False,,expense_history_csv,Consolidated_Expense_History_20250622.csv,2025-07-18T12:32:53.413399,3.0,advanced_calculations_v3,exp_v3_001116,2024.00,7.00,3.00,False,False,False,True,40
Jordyn,2024-07-03,,Amazon,,19.10,19.10,,,,19.10,19.10,0.00,simple,False,,expense_history_csv,Consolidated_Expense_History_20250622.csv,2025-07-18T12:32:53.413399,3.0,advanced_calculations_v3,exp_v3_001117,2024.00,7.00,3.00,False,False,False,True,40
Jordyn,2024-07-03,,Postino's,,41.84,41.84,,,,41.84,41.84,0.00,simple,False,,expense_history_csv,Consolidated_Expense_History_20250622.csv,2025-07-18T12:32:53.413399,3.0,advanced_calculations_v3,exp_v3_001118,2024.00,7.00,3.00,False,False,False,True,40
Jordyn,2024-07-03,,Vet Doctor of Chandler,,380.00,380.00,Ollie (aka Prince Ali!),,,380.00,380.00,1.00,simple,False,Mathematical operation: (aka Prince Ali!),expense_history_csv,Consolidated_Expense_History_20250622.csv,2025-07-18T12:32:53.413399,3.0,advanced_calculations_v3,exp_v3_001119,2024.00,7.00,3.00,False,False,False,True,60
Name,,Account,Merchant,Merchant Description,,,Description,Category,,,,0.00,simple,False,,expense_history_csv,Consolidated_Expense_History_20250622.csv,2025-07-18T12:32:53.413399,3.0,advanced_calculations_v3,exp_v3_001120,,,,False,False,False,False,0
Ryan,2024-07-01,Capital One Quicksilver ****5473,DD DOORDASH DOGHAUS,DoorDash,38.45,38.45,,Dining & Drinks,38.45,38.45,38.45,0.00,simple,False,,expense_history_csv,Consolidated_Expense_History_20250622.csv,2025-07-18T12:32:53.413399,3.0,advanced_calculations_v3,exp_v3_001121,2024.00,7.00,3.00,False,False,False,True,40
Ryan,2024-07-27,Capital One Quicksilver ****5473,DD *DOORDASHDASHPASS,DoorDash,4.99,4.99,,Dining & Drinks,43.44,4.99,4.99,0.00,simple,False,,expense_history_csv,Consolidated_Expense_History_20250622.csv,2025-07-18T12:32:53.413399,3.0,advanced_calculations_v3,exp_v3_001122,2024.00,7.00,3.00,False,False,False,True,40
Ryan,2024-07-29,Capital One Quicksilver ****5473,DD DOORDASH WALGREENS,DoorDash (Walgreens),31.81,31.81,,Dining & Drinks,75.25,31.81,31.81,0.00,simple,False,,expense_history_csv,Consolidated_Expense_History_20250622.csv,2025-07-18T12:32:53.413399,3.0,advanced_calculations_v3,exp_v3_001123,2024.00,7.00,3.00,False,False,False,True,40
Ryan,2024-08-27,Capital One Quicksilver ****5473,DD *DOORDASHDASHPASS,DoorDash,4.99,4.99,,Dining & Drinks,80.24,4.99,4.99,0.00,simple,False,,expense_history_csv,Consolidated_Expense_History_20250622.csv,2025-07-18T12:32:53.413399,3.0,advanced_calculations_v3,exp_v3_001124,2024.00,8.00,3.00,False,False,False,True,40
Ryan,2024-09-02,Capital One Quicksilver ****5473,DD *DOORDASH BOWLHAUS,DoorDash,38.48,38.48,,Dining & Drinks,118.72,38.48,38.48,0.00,simple,False,,expense_history_csv,Consolidated_Expense_History_20250622.csv,2025-07-18T12:32:53.413399,3.0,advanced_calculations_v3,exp_v3_001125,2024.00,9.00,3.00,False,False,False,True,40
Ryan,2024-09-03,Capital One Quicksilver ****5473,DD *DOORDASH STKSTEAKH,DoorDash,57.36,57.36,,Dining & Drinks,176.08,57.36,57.36,0.00,simple,False,,expense_history_csv,Consolidated_Expense_History_20250622.csv,2025-07-18T12:32:53.413399,3.0,advanced_calculations_v3,exp_v3_001126,2024.00,9.00,3.00,False,False,False,True,40
Ryan,2024-09-17,Capital One Quicksilver ****5473,DD *DOORDASH WALGREENS,DoorDash (Walgreens),15.68,15.68,,Dining & Drinks,191.76,15.68,15.68,0.00,simple,False,,expense_history_csv,Consolidated_Expense_History_20250622.csv,2025-07-18T12:32:53.413399,3.0,advanced_calculations_v3,exp_v3_001127,2024.00,9.00,3.00,False,False,False,True,40
Ryan,2024-09-27,Capital One Quicksilver ****5473,DD *DOORDASHDASHPASS,DoorDash,4.99,4.99,,Dining & Drinks,196.75,4.99,4.99,0.00,simple,False,,expense_history_csv,Consolidated_Expense_History_20250622.csv,2025-07-18T12:32:53.413399,3.0,advanced_calculations_v3,exp_v3_001128,2024.00,9.00,3.00,False,False,False,True,40
Ryan,2024-07-06,Capital One SavorOne ****2463,Fry's Food and Drug,Fry's,23.07,23.07,"Joel Gott Cabernet Sauvignon, Popchips Nacho Popped Snack",Groceries,219.82,23.07,23.07,0.00,simple,False,,expense_history_csv,Consolidated_Expense_History_20250622.csv,2025-07-18T12:32:53.413399,3.0,advanced_calculations_v3,exp_v3_001129,2024.00,7.00,3.00,False,False,False,True,60
Ryan,2024-07-09,Capital One SavorOne ****2463,Fry's Food and Drug,Fry's,41.44,41.44,,Groceries,261.26,41.44,41.44,0.00,simple,False,,expense_history_csv,Consolidated_Expense_History_20250622.csv,2025-07-18T12:32:53.413399,3.0,advanced_calculations_v3,exp_v3_001130,2024.00,7.00,3.00,False,False,False,True,40
Ryan,2024-07-10,Capital One SavorOne ****2463,Fry's Food and Drug,Fry's,31.87,31.87,"Joel Gott Cabernet, Kim Crawford Sauvignon Blanc",Groceries,293.13,31.87,31.87,0.00,simple,False,,expense_history_csv,Consolidated_Expense_History_20250622.csv,2025-07-18T12:32:53.413399,3.0,advanced_calculations_v3,exp_v3_001131,2024.00,7.00,3.00,False,False,False,True,60
Ryan,2024-07-11,Capital One SavorOne ****2463,Fry's Food and Drug,Fry's,30.19,30.19,,Groceries,323.32,30.19,30.19,0.00,simple,False,,expense_history_csv,Consolidated_Expense_History_20250622.csv,2025-07-18T12:32:53.413399,3.0,advanced_calculations_v3,exp_v3_001132,2024.00,7.00,3.00,False,False,False,True,40
Ryan,2024-07-12,Capital One SavorOne ****2463,Fry's Food and Drug,Fry's,36.43,36.43,"Joel Gott Cabernet, Kim Crawford Sauvignon Blanc, Simply Orange Juice",Groceries,359.75,36.43,36.43,0.00,simple,False,,expense_history_csv,Consolidated_Expense_History_20250622.csv,2025-07-18T12:32:53.413399,3.0,advanced_calculations_v3,exp_v3_001133,2024.00,7.00,3.00,False,False,False,True,60
Ryan,2024-07-13,Capital One SavorOne ****2463,Fry's Food and Drug,Fry's,47.70,47.70,"Cutwater Mango Margarita, Joel Gott Cabernet Sauvignon, Kim Crawford Sauvignon Blanc, Kroger Pure Pumpkin",Groceries,407.45,47.70,47.70,0.00,simple,False,,expense_history_csv,Consolidated_Expense_History_20250622.csv,2025-07-18T12:32:53.413399,3.0,advanced_calculations_v3,exp_v3_001134,2024.00,7.00,3.00,False,False,False,True,60
Ryan,2024-07-15,Capital One SavorOne ****2463,Fry's Food and Drug,Fry's,49.73,49.73,"Cutwater Mango Margarita, Fry's Purified Water, Joel Gott Cabernet, Kim Crawford Sauvignon Blanc",Groceries,457.18,49.73,49.73,0.00,simple,False,,expense_history_csv,Consolidated_Expense_History_20250622.csv,2025-07-18T12:32:53.413399,3.0,advanced_calculations_v3,exp_v3_001135,2024.00,7.00,3.00,False,False,False,True,60
Ryan,2024-07-17,Capital One SavorOne ****2463,Fry's Food and Drug,Fry's,31.87,31.87,"Joel Gott Cabernet Sauvignon, Kim Crawford Sauvignon Blanc",Groceries,489.05,31.87,31.87,0.00,simple,False,,expense_history_csv,Consolidated_Expense_History_20250622.csv,2025-07-18T12:32:53.413399,3.0,advanced_calculations_v3,exp_v3_001136,2024.00,7.00,3.00,False,False,False,True,60
Ryan,2024-07-19,Capital One SavorOne ****2463,Fry's Food and Drug,Fry's,44.93,44.93,"Joel Gott Cabernet Sauvignon, Kim Crawford Sauvignon Blanc, White Claw Variety Pack No.3",Groceries,533.98,44.93,44.93,0.00,simple,False,,expense_history_csv,Consolidated_Expense_History_20250622.csv,2025-07-18T12:32:53.413399,3.0,advanced_calculations_v3,exp_v3_001137,2024.00,7.00,3.00,False,False,False,True,60
Ryan,2024-07-20,Capital One SavorOne ****2463,Fry's Food and Drug,Fry's,30.24,30.24,"Cutwater Mango Margarita, Simple Truth Organic Greek Yogurt, White Claw Hard Seltzer Variety Pack No.2",Groceries,564.22,30.24,30.24,0.00,simple,False,,expense_history_csv,Consolidated_Expense_History_20250622.csv,2025-07-18T12:32:53.413399,3.0,advanced_calculations_v3,exp_v3_001138,2024.00,7.00,3.00,False,False,False,True,60
Ryan,2024-07-22,Capital One SavorOne ****2463,Fry's Food and Drug,Fry's,10.62,10.62,Cutwater Mango Margarita,Groceries,574.84,10.62,10.62,0.00,simple,False,,expense_history_csv,Consolidated_Expense_History_20250622.csv,2025-07-18T12:32:53.413399,3.0,advanced_calculations_v3,exp_v3_001139,2024.00,7.00,3.00,False,False,False,True,60
Ryan,2024-07-23,Capital One SavorOne ****2463,Fry's Food and Drug,Fry's,58.93,58.93,"Cutwater Mango Margarita, Fresh Bananas, Home Chef Cold Baked Chicken, Kim Crawford Sauvignon Blanc, Luna Bars",Groceries,633.77,58.93,58.93,0.00,simple,False,,expense_history_csv,Consolidated_Expense_History_20250622.csv,2025-07-18T12:32:53.413399,3.0,advanced_calculations_v3,exp_v3_001140,2024.00,7.00,3.00,False,False,False,True,60
Ryan,2024-07-24,Capital One SavorOne ****2463,Fry's Food and Drug,Fry's,51.97,51.97,"Joel Gott Cabernet Sauvignon, Kim Crawford Sauvignon Blanc, Kroger Pure Pumpkin, White Claw Variety Pack No.3",Groceries,685.74,51.97,51.97,0.00,simple,False,,expense_history_csv,Consolidated_Expense_History_20250622.csv,2025-07-18T12:32:53.413399,3.0,advanced_calculations_v3,exp_v3_001141,2024.00,7.00,3.00,False,False,False,True,60
Ryan,2024-07-30,Capital One SavorOne ****2463,Fry's Food and Drug,Fry's,50.32,50.32,,Groceries,736.06,50.32,50.32,0.00,simple,False,,expense_history_csv,Consolidated_Expense_History_20250622.csv,2025-07-18T12:32:53.413399,3.0,advanced_calculations_v3,exp_v3_001142,2024.00,7.00,3.00,False,False,False,True,40
Ryan,2024-07-31,Capital One SavorOne ****2463,Fry's Food and Drug,Fry's,79.90,79.90,"Albanese Gummi Bears, Claussen Pickles, Cutwater Mango Margarita, Haribo Gummi Bears, Joel Gott Cabernet",Groceries,815.96,79.90,79.90,0.00,simple,False,,expense_history_csv,Consolidated_Expense_History_20250622.csv,2025-07-18T12:32:53.413399,3.0,advanced_calculations_v3,exp_v3_001143,2024.00,7.00,3.00,False,False,False,True,60
Ryan,2024-08-01,Capital One SavorOne ****2463,Fry's Food and Drug,Fry's,47.46,47.46,"Joel Gott Cabernet, Kroger Distilled Water, Kroger Tall Kitchen Bags, Luna Bars",Groceries,863.42,47.46,47.46,0.00,simple,False,,expense_history_csv,Consolidated_Expense_History_20250622.csv,2025-07-18T12:32:53.413399,3.0,advanced_calculations_v3,exp_v3_001144,2024.00,8.00,3.00,False,False,False,True,60
Ryan,2024-08-02,Capital One SavorOne ****2463,Fry's Food and Drug,Fry's,39.93,39.93,"Cutwater Tequila Mango Margarita, Home Chef Cold Baked Chicken, Joel Gott Cabernet Sauvignon",Groceries,903.35,39.93,39.93,0.00,simple,False,,expense_history_csv,Consolidated_Expense_History_20250622.csv,2025-07-18T12:32:53.413399,3.0,advanced_calculations_v3,exp_v3_001145,2024.00,8.00,3.00,False,False,False,True,60
Ryan,2024-08-05,Capital One SavorOne ****2463,Chevron,Chevron,3.06,3.06,,Auto & Transport,906.41,3.06,3.06,0.00,simple,False,,expense_history_csv,Consolidated_Expense_History_20250622.csv,2025-07-18T12:32:53.413399,3.0,advanced_calculations_v3,exp_v3_001146,2024.00,8.00,3.00,False,False,False,True,40
Ryan,2024-08-05,Capital One SavorOne ****2463,Fry's Food and Drug,Fry's,42.49,42.49,"Cutwater Tequila Mango Margarita, Parkers Estate Pinot Noir, Vizzy Hard Seltzer Tropical Variety Pack",Groceries,948.90,42.49,42.49,0.00,simple,False,,expense_history_csv,Consolidated_Expense_History_20250622.csv,2025-07-18T12:32:53.413399,3.0,advanced_calculations_v3,exp_v3_001147,2024.00,8.00,3.00,False,False,False,True,60
Ryan,2024-08-05,Capital One SavorOne ****2463,Fry's Food and Drug,Fry's,53.68,53.68,"Ben & Jerry's Cherry Garcia Ice Cream, Canada Dry Ginger Ale, Freschetta Gluten-Free Pizza, Fresh Bananas, Bottled Water, Luna Bars",Groceries,1002.58,53.68,53.68,0.00,simple,False,,expense_history_csv,Consolidated_Expense_History_20250622.csv,2025-07-18T12:32:53.413399,3.0,advanced_calculations_v3,exp_v3_001148,2024.00,8.00,3.00,False,False,False,True,60
Ryan,2024-08-06,Capital One SavorOne ****2463,Fry's Food and Drug,Fry's,44.25,44.25,"Charleston Chew Candy, Cutwater Tequila Mango Margarita, Haribo Gummi Bears, Home Chef Chicken, Jack Link's Teriyaki Beef Jerky",Groceries,1046.83,44.25,44.25,0.00,simple,False,,expense_history_csv,Consolidated_Expense_History_20250622.csv,2025-07-18T12:32:53.413399,3.0,advanced_calculations_v3,exp_v3_001149,2024.00,8.00,3.00,False,False,False,True,60
Ryan,2024-08-07,Capital One SavorOne ****2463,Fry's Food and Drug,Fry's,23.53,23.53,"Daisy Light Sour Cream, Kim Crawford Sauvignon Blanc, Oikos Pro Yogurt",Groceries,1070.36,23.53,23.53,0.00,simple,False,,expense_history_csv,Consolidated_Expense_History_20250622.csv,2025-07-18T12:32:53.413399,3.0,advanced_calculations_v3,exp_v3_001150,2024.00,8.00,3.00,False,False,False,True,60
Ryan,2024-09-11,Capital One SavorOne ****2463,Fry's Food and Drug,Fry's,61.41,61.41,,Groceries,1131.77,61.41,61.41,0.00,simple,False,,expense_history_csv,Consolidated_Expense_History_20250622.csv,2025-07-18T12:32:53.413399,3.0,advanced_calculations_v3,exp_v3_001151,2024.00,9.00,3.00,False,False,False,True,40
Ryan,2024-09-13,Capital One SavorOne ****2463,Fry's Food and Drug,Fry's,22.93,22.93,"Home Chef Chicken, Kim Crawford Sauvignon Blanc",Groceries,1154.70,22.93,22.93,0.00,simple,False,,expense_history_csv,Consolidated_Expense_History_20250622.csv,2025-07-18T12:32:53.413399,3.0,advanced_calculations_v3,exp_v3_001152,2024.00,9.00,3.00,False,False,False,True,60
Ryan,2024-09-14,Capital One SavorOne ****2463,Fry's Food and Drug,Fry's,32.09,32.09,"Chevalier Sauvignon Blanc, McBride Sisters Sauvignon Blanc",Groceries,1186.79,32.09,32.09,0.00,simple,False,,expense_history_csv,Consolidated_Expense_History_20250622.csv,2025-07-18T12:32:53.413399,3.0,advanced_calculations_v3,exp_v3_001153,2024.00,9.00,3.00,False,False,False,True,60
Ryan,2024-09-17,Capital One SavorOne ****2463,Fry's Food and Drug,Fry's,82.21,82.21,"34 Degrees Cheese Crisps, Freschetta Gluten-Free Pizza, Kim Crawford Sauvignon Blanc, Luna Nutrition Bars, Matchbook Chardonnay, Tito's Vodka",Groceries,1269.00,82.21,82.21,0.00,simple,False,,expense_history_csv,Consolidated_Expense_History_20250622.csv,2025-07-18T12:32:53.413399,3.0,advanced_calculations_v3,exp_v3_001154,2024.00,9.00,3.00,False,False,False,True,60
Ryan,2024-09-17,Capital One SavorOne ****2463,Fry's Food and Drug,Fry's,48.41,48.41,"Home Chef Chicken, Kim Crawford Sauvignon Blanc, Kroger Peeled Baby Carrots, Luna Bar, White Claw Variety Pack, Resolve Pet Cleaner",Groceries,1317.41,48.41,48.41,0.00,simple,False,,expense_history_csv,Consolidated_Expense_History_20250622.csv,2025-07-18T12:32:53.413399,3.0,advanced_calculations_v3,exp_v3_001155,2024.00,9.00,3.00,False,False,False,True,60
Ryan,2024-09-17,Capital One SavorOne ****2463,Fry's Food and Drug,Fry's,29.74,29.74,"Kim Crawford Sauvignon Blanc, Raeburn Chardonnay",Groceries,1347.15,29.74,29.74,0.00,simple,False,,expense_history_csv,Consolidated_Expense_History_20250622.csv,2025-07-18T12:32:53.413399,3.0,advanced_calculations_v3,exp_v3_001156,2024.00,9.00,3.00,False,False,False,True,60
Ryan,2024-09-20,Capital One SavorOne ****2463,Capital One,Fry's Food and Drug,51.33,51.33,FRYS-FOOD-DRG #051,Groceries,1398.48,51.33,51.33,0.00,simple,False,,expense_history_csv,Consolidated_Expense_History_20250622.csv,2025-07-18T12:32:53.413399,3.0,advanced_calculations_v3,exp_v3_001157,2024.00,9.00,3.00,False,False,False,True,60
Ryan,2024-09-21,Capital One SavorOne ****2463,WHOLEFDS CHR 10272,Whole Foods,41.37,41.37,,Groceries,1439.85,41.37,41.37,0.00,simple,False,,expense_history_csv,Consolidated_Expense_History_20250622.csv,2025-07-18T12:32:53.413399,3.0,advanced_calculations_v3,exp_v3_001158,2024.00,9.00,3.00,False,False,False,True,40
Ryan,2024-08-09,Credit One Bank Visa ****1559,Kindle Unltd*RM7WV2AI0 888-802-3080 WA,Amazon Kindle,12.93,12.93,,Subscription,1452.78,12.93,12.93,0.00,simple,False,,expense_history_csv,Consolidated_Expense_History_20250622.csv,2025-07-18T12:32:53.413399,3.0,advanced_calculations_v3,exp_v3_001159,2024.00,8.00,3.00,False,False,False,True,40
Ryan,2024-07-01,Credit One Visa ****6396,FRYS-FOOD-DRG #051 CHANDLER AZ D,Fry's Food and Drug,53.33,53.33,,Groceries,1506.11,53.33,53.33,0.00,simple,False,,expense_history_csv,Consolidated_Expense_History_20250622.csv,2025-07-18T12:32:53.413399,3.0,advanced_calculations_v3,exp_v3_001160,2024.00,7.00,3.00,False,False,False,True,40
Ryan,2024-07-02,Credit One Visa ****6396,FRYS-FOOD-DRG #051 CHANDLER AZ D,Fry's Food and Drug,33.52,33.52,,Groceries,1539.63,33.52,33.52,0.00,simple,False,,expense_history_csv,Consolidated_Expense_History_20250622.csv,2025-07-18T12:32:53.413399,3.0,advanced_calculations_v3,exp_v3_001161,2024.00,7.00,3.00,False,False,False,True,40
Ryan,2024-07-24,Credit One Visa ****6396,FRYS-FOOD-DRG #051 CHANDLER AZ D,Fry's Food and Drug,29.00,29.00,"Famous Dave's Pickles, Harvest Snaps Mango Chile Lime, Kim Crawford Sauvignon Blanc, Luna Bars",Groceries,1568.63,29.00,29.00,0.00,simple,False,,expense_history_csv,Consolidated_Expense_History_20250622.csv,2025-07-18T12:32:53.413399,3.0,advanced_calculations_v3,exp_v3_001162,2024.00,7.00,3.00,False,False,False,True,60
Ryan,2024-08-06,Credit One Visa ****6396,FRYS 5623 866-576-4377 AZ,Fry's,101.59,101.59,"Broccoli, Capri Sun Juice Pouches, Chicken of the Sea Tuna, Foster Farms Chicken Breast, Bananas, Green Beans, Bell Peppers, Raisin Bran Crunch, Ground Beef, Spinach, Eggs, Oikos Yogurt, Old Spice Body Wash, and more",Groceries,1670.22,101.59,101.59,0.00,simple,False,,expense_history_csv,Consolidated_Expense_History_20250622.csv,2025-07-18T12:32:53.413399,3.0,advanced_calculations_v3,exp_v3_001163,2024.00,8.00,3.00,False,False,False,True,60
Ryan,2024-08-07,Credit One Visa ****6396,FRYS-FOOD-DRG #051 CHANDLER AZ D,Fry's Food and Drug,36.74,36.74,"Cutwater Tequila Mango Margarita, Home Chef Cold Baked Chicken, Kim Crawford Sauvignon Blanc",Groceries,1706.96,36.74,36.74,0.00,simple,False,,expense_history_csv,Consolidated_Expense_History_20250622.csv,2025-07-18T12:32:53.413399,3.0,advanced_calculations_v3,exp_v3_001164,2024.00,8.00,3.00,False,False,False,True,60
Ryan,2024-08-08,Credit One Visa ****6396,FRYS-FOOD-DRG #051 CHANDLER AZ D,Fry's Food and Drug,28.50,28.50,"Claussen Kosher Dill Pickles, Kim Crawford Sauvignon Blanc, Polar Lime Seltzer Water, Yogi Throat Comfort Tea",Groceries,1735.46,28.50,28.50,0.00,simple,False,,expense_history_csv,Consolidated_Expense_History_20250622.csv,2025-07-18T12:32:53.413399,3.0,advanced_calculations_v3,exp_v3_001165,2024.00,8.00,3.00,False,False,False,True,60
Ryan,2024-08-09,Credit One Visa ****6396,FRYS-FOOD-DRG #051 CHANDLER AZ D,Fry's Food and Drug,30.81,30.81,"Joel Gott Cabernet Sauvignon, Kim Crawford Sauvignon Blanc",Groceries,1766.27,30.81,30.81,0.00,simple,False,,expense_history_csv,Consolidated_Expense_History_20250622.csv,2025-07-18T12:32:53.413399,3.0,advanced_calculations_v3,exp_v3_001166,2024.00,8.00,3.00,False,False,False,True,60
Ryan,2024-08-10,Credit One Visa ****6396,FRYS-FOOD-DRG #051 CHANDLER AZ D,Fry's Food and Drug,32.94,32.94,Tito's Handmade Vodka,Groceries,1799.21,32.94,32.94,0.00,simple,False,,expense_history_csv,Consolidated_Expense_History_20250622.csv,2025-07-18T12:32:53.413399,3.0,advanced_calculations_v3,exp_v3_001167,2024.00,8.00,3.00,False,False,False,True,60
Ryan,2024-08-11,Credit One Visa ****6396,FRYS-FOOD-DRG #051 CHANDLER AZ D,Fry's Food and Drug,38.25,38.25,"Amy's Gluten Free Broccoli & Cheddar Bake, Cutwater Tequila Mango Margarita, Famous Dave's Pickle Chips, Freschetta Gluten Free Pizza, Fresh Bananas",Groceries,1837.46,38.25,38.25,0.00,simple,False,,expense_history_csv,Consolidated_Expense_History_20250622.csv,2025-07-18T12:32:53.413399,3.0,advanced_calculations_v3,exp_v3_001168,2024.00,8.00,3.00,False,False,False,True,60
Ryan,2024-08-12,Credit One Visa ****6396,FRYS-FOOD-DRG #051 CHANDLER AZ D,Fry's Food and Drug,87.09,87.09,"Ace Elastic Bandage, Band-Aid Flexible Bandages, Home Chef Cold Baked Chicken, Joel Gott Cabernet, Isopropyl Alcohol, KT Tape Pro Therapeutic Tape",Groceries,1924.55,87.09,87.09,0.00,simple,False,,expense_history_csv,Consolidated_Expense_History_20250622.csv,2025-07-18T12:32:53.413399,3.0,advanced_calculations_v3,exp_v3_001169,2024.00,8.00,3.00,False,False,False,True,60
Ryan,2024-08-13,Credit One Visa ****6396,FRYS-FOOD-DRG #051 CHANDLER AZ D,Fry's Food and Drug,30.81,30.81,"Cutwater Tequila Mango Margarita, Joel Gott Cabernet Sauvignon",Groceries,1955.36,30.81,30.81,0.00,simple,False,,expense_history_csv,Consolidated_Expense_History_20250622.csv,2025-07-18T12:32:53.413399,3.0,advanced_calculations_v3,exp_v3_001170,2024.00,8.00,3.00,False,False,False,True,60
Ryan,2024-08-14,Credit One Visa ****6396,FRYS-FOOD-DRG #051 CHANDLER AZ D,Fry's Food and Drug,44.41,44.41,"Cutwater Tequila Mango Margarita (2 packs), Joel Gott Cabernet Sauvignon, Polar Lime Flavored Seltzer Water",Groceries,1999.77,44.41,44.41,1.00,simple,False,Mathematical operation: (2 packs),expense_history_csv,Consolidated_Expense_History_20250622.csv,2025-07-18T12:32:53.413399,3.0,advanced_calculations_v3,exp_v3_001171,2024.00,8.00,3.00,False,False,False,True,60
Ryan,2024-08-15,Credit One Visa ****6396,FRYS-FOOD-DRG #051 CHANDLER AZ D,Fry's Food and Drug,30.54,30.54,"Home Chef Cold Baked Chicken, Kim Crawford Sauvignon Blanc, Luna Mash-Ups Lemonzest + Raspberry Bars",Groceries,2030.31,30.54,30.54,0.00,simple,False,,expense_history_csv,Consolidated_Expense_History_20250622.csv,2025-07-18T12:32:53.413399,3.0,advanced_calculations_v3,exp_v3_001172,2024.00,8.00,3.00,False,False,False,True,60
Ryan,2024-08-16,Credit One Visa ****6396,FRYS-FOOD-DRG #051 CHANDLER AZ D,Fry's Food and Drug,49.84,49.84,"Cutwater Tequila Mango Margarita (2 packs), Ely By Callaway Cabernet Sauvignon, The Crossings Sauvignon Blanc",Groceries,2080.15,49.84,49.84,1.00,simple,False,Mathematical operation: (2 packs),expense_history_csv,Consolidated_Expense_History_20250622.csv,2025-07-18T12:32:53.413399,3.0,advanced_calculations_v3,exp_v3_001173,2024.00,8.00,3.00,False,False,False,True,60
Ryan,2024-08-17,Credit One Visa ****6396,FRYS-FOOD-DRG #051 CHANDLER AZ D,Fry's Food and Drug,96.62,96.62,"Band-Aid Flexible Bandages, Charmin Ultra Soft Toilet Paper, The Crossings Sauvignon Blanc (2 bottles)",Groceries,2176.77,96.62,96.62,1.00,simple,False,Mathematical operation: (2 bottles),expense_history_csv,Consolidated_Expense_History_20250622.csv,2025-07-18T12:32:53.413399,3.0,advanced_calculations_v3,exp_v3_001174,2024.00,8.00,3.00,False,False,False,True,60
Ryan,2024-08-18,Credit One Visa ****6396,FRYS-FOOD-DRG #051 CHANDLER AZ D,Fry's Food and Drug,50.65,50.65,"Bubly Sparkling Water (multiple flavors), Dawn Heavy Duty Scouring Pads, Kroger Allergy Nasal Spray, Carrots, Sponges",Groceries,2227.42,50.65,50.65,1.00,simple,False,Mathematical operation: (multiple flavors),expense_history_csv,Consolidated_Expense_History_20250622.csv,2025-07-18T12:32:53.413399,3.0,advanced_calculations_v3,exp_v3_001175,2024.00,8.00,3.00,False,False,False,True,60
Ryan,2024-08-21,Credit One Visa ****6396,FRYS-FOOD-DRG #051 CHANDLER AZ,Fry's Food and Drug,22.98,22.98,"Fresh Banana, Home Chef Cold Baked Chicken, KIND Healthy Grains Vanilla Blueberry Granola, Luna Mash-Ups Bars",Groceries,2250.40,22.98,22.98,0.00,simple,False,,expense_history_csv,Consolidated_Expense_History_20250622.csv,2025-07-18T12:32:53.413399,3.0,advanced_calculations_v3,exp_v3_001176,2024.00,8.00,3.00,False,False,False,True,60
Ryan,2024-08-22,Credit One Visa ****6396,FRYS-FOOD-DRG #051 CHANDLER AZ,Fry's Food and Drug,27.58,27.58,"Dawn Heavy Duty Scouring Pads, Harvest Snaps Mango Chile Lime Crisps, Kroger Allergy Nasal Spray, Baby Carrots, Scotch-Brite Sponges",Groceries,2277.98,27.58,27.58,0.00,simple,False,,expense_history_csv,Consolidated_Expense_History_20250622.csv,2025-07-18T12:32:53.413399,3.0,advanced_calculations_v3,exp_v3_001177,2024.00,8.00,3.00,False,False,False,True,60
Ryan,2024-08-23,Credit One Visa ****6396,FRYS-FOOD-DRG #051 CHANDLER AZ,Fry's Food and Drug,11.14,11.14,"Home Chef Cold Baked Chicken, Kroger 100% Pure Pumpkin",Groceries,2289.12,11.14,11.14,0.00,simple,False,,expense_history_csv,Consolidated_Expense_History_20250622.csv,2025-07-18T12:32:53.413399,3.0,advanced_calculations_v3,exp_v3_001178,2024.00,8.00,3.00,False,False,False,True,60
Ryan,2024-08-25,Credit One Visa ****6396,FRYS-FOOD-DRG #051 CHANDLER AZ,Fry's Food and Drug,13.09,13.09,"Kroger Distilled Gallon Bottled Water, Strongbow Gold Apple Hard Cider 6-Pack",Groceries,2302.21,13.09,13.09,0.00,simple,False,,expense_history_csv,Consolidated_Expense_History_20250622.csv,2025-07-18T12:32:53.413399,3.0,advanced_calculations_v3,exp_v3_001179,2024.00,8.00,3.00,False,False,False,True,60
Ryan,2024-08-25,Credit One Visa ****6396,FRYS-FOOD-DRG #051 CHANDLER AZ,Fry's Food and Drug,36.99,36.99,"34 Degrees Cheese Crisps, Tito's Handmade Vodka",Groceries,2339.20,36.99,36.99,0.00,simple,False,,expense_history_csv,Consolidated_Expense_History_20250622.csv,2025-07-18T12:32:53.413399,3.0,advanced_calculations_v3,exp_v3_001180,2024.00,8.00,3.00,False,False,False,True,60
Ryan,2024-08-28,Credit One Visa ****6396,FRYS-FOOD-DRG #051 CHANDLER AZ,Fry's Food and Drug,9.12,9.12,Home Chef Cold Baked Chicken,Groceries,2348.32,9.12,9.12,0.00,simple,False,,expense_history_csv,Consolidated_Expense_History_20250622.csv,2025-07-18T12:32:53.413399,3.0,advanced_calculations_v3,exp_v3_001181,2024.00,8.00,3.00,False,False,False,True,60
Ryan,2024-08-28,Credit One Visa ****6396,FRYS-FOOD-DRG #051 CHANDLER AZ,Fry's Food and Drug,21.54,21.54,"Bumble Bee Tuna, Haribo Gummy Candy, Schar Gluten-Free Ciabatta, Swedish Fish",Groceries,2369.86,21.54,21.54,0.00,simple,False,,expense_history_csv,Consolidated_Expense_History_20250622.csv,2025-07-18T12:32:53.413399,3.0,advanced_calculations_v3,exp_v3_001182,2024.00,8.00,3.00,False,False,False,True,60
Ryan,2024-08-29,Credit One Visa ****6396,FRYS-FOOD-DRG #051 CHANDLER AZ,Fry's Food and Drug,25.44,25.44,"Famous Dave's Pickle Chips, Good Culture Cottage Cheese, Success Boil-in-Bag Brown Rice, White Claw",Groceries,2395.30,25.44,25.44,0.00,simple,False,,expense_history_csv,Consolidated_Expense_History_20250622.csv,2025-07-18T12:32:53.413399,3.0,advanced_calculations_v3,exp_v3_001183,2024.00,8.00,3.00,False,False,False,True,60
Ryan,2024-08-30,Credit One Visa ****6396,FRYS-FOOD-DRG #051 CHANDLER AZ,Fry's Food and Drug,17.00,17.00,White Claw Hard Seltzer Variety Pack No. 3,Groceries,2412.30,17.00,17.00,0.00,simple,False,,expense_history_csv,Consolidated_Expense_History_20250622.csv,2025-07-18T12:32:53.413399,3.0,advanced_calculations_v3,exp_v3_001184,2024.00,8.00,3.00,False,False,False,True,60
Ryan,2024-08-31,Credit One Visa ****6396,FRYS-FOOD-DRG #051 CHANDLER AZ,Fry's Food and Drug,55.23,55.23,"Joel Gott Cabernet, Kim Crawford Sauvignon Blanc, Strongbow Gold Apple Hard Cider",Groceries,2467.53,55.23,55.23,0.00,simple,False,,expense_history_csv,Consolidated_Expense_History_20250622.csv,2025-07-18T12:32:53.413399,3.0,advanced_calculations_v3,exp_v3_001185,2024.00,8.00,3.00,False,False,False,True,60
Ryan,2024-09-04,Credit One Visa ****6396,FRYS-FOOD-DRG #051 CHANDLER AZ D,Fry's Food and Drug,29.74,29.74,"Invivo X by Sarah Jessica Parker Sauvignon Blanc, Korbel Brut Champagne",Groceries,2497.27,29.74,29.74,0.00,simple,False,,expense_history_csv,Consolidated_Expense_History_20250622.csv,2025-07-18T12:32:53.413399,3.0,advanced_calculations_v3,exp_v3_001186,2024.00,9.00,3.00,False,False,False,True,60
Ryan,2024-09-05,Credit One Visa ****6396,FRYS-FOOD-DRG #051 CHANDLER AZ D,Fry's Food and Drug,48.56,48.56,"Ben & Jerry's Cherry Garcia Ice Cream, Haribo Gummy Bears, Kim Crawford Sauvignon Blanc, Home Chef Chicken",Groceries,2545.83,48.56,48.56,0.00,simple,False,,expense_history_csv,Consolidated_Expense_History_20250622.csv,2025-07-18T12:32:53.413399,3.0,advanced_calculations_v3,exp_v3_001187,2024.00,9.00,3.00,False,False,False,True,60
Ryan,2024-09-06,Credit One Visa ****6396,FRYS-FOOD-DRG #051 CHANDLER AZ D,Fry's Food and Drug,26.16,26.16,"34 Degrees Cheese Crisps, Salmon/Nigiri Combo, Spicy California Sushi Roll",Groceries,2571.99,26.16,26.16,0.00,simple,False,,expense_history_csv,Consolidated_Expense_History_20250622.csv,2025-07-18T12:32:53.413399,3.0,advanced_calculations_v3,exp_v3_001188,2024.00,9.00,3.00,False,False,False,True,60
Ryan,2024-09-06,Credit One Visa ****6396,FRYS-FOOD-DRG #051 CHANDLER AZ D,Fry's Food and Drug,64.10,64.10,"Joel Gott Cabernet, Kim Crawford Sauvignon Blanc, Tito's Vodka, Kroger Distilled Water",Groceries,2636.09,64.10,64.10,0.00,simple,False,,expense_history_csv,Consolidated_Expense_History_20250622.csv,2025-07-18T12:32:53.413399,3.0,advanced_calculations_v3,exp_v3_001189,2024.00,9.00,3.00,False,False,False,True,60
Ryan,2024-09-09,Credit One Visa ****6396,FRYS-FOOD-DRG #051 CHANDLER AZ D,Fry's Food and Drug,22.43,22.43,"Haribo Goldbears Gummi Candy, Kim Crawford Sauvignon Blanc",Groceries,2658.52,22.43,22.43,0.00,simple,False,,expense_history_csv,Consolidated_Expense_History_20250622.csv,2025-07-18T12:32:53.413399,3.0,advanced_calculations_v3,exp_v3_001190,2024.00,9.00,3.00,False,False,False,True,60
Ryan,2024-09-17,Credit One Visa ****6396,FRYS-FOOD-DRG #051 CHANDLER AZ D,Fry's Food and Drug,21.62,21.62,"Fresh Banana, Kim Crawford Sauvignon Blanc, Oikos Triple Zero Yogurt",Groceries,2680.14,21.62,21.62,0.00,simple,False,,expense_history_csv,Consolidated_Expense_History_20250622.csv,2025-07-18T12:32:53.413399,3.0,advanced_calculations_v3,exp_v3_001191,2024.00,9.00,3.00,False,False,False,True,60
Ryan,2024-09-18,Credit One Visa ****6396,FRYS-FOOD-DRG #051 CHANDLER AZ D,Fry's Food and Drug,66.05,66.05,"Daisy Sour Cream, Kim Crawford Sauvignon Blanc, KIND Granola, Luna Bars, Luna Mash-Ups",Groceries,2746.19,66.05,66.05,0.00,simple,False,,expense_history_csv,Consolidated_Expense_History_20250622.csv,2025-07-18T12:32:53.413399,3.0,advanced_calculations_v3,exp_v3_001192,2024.00,9.00,3.00,False,False,False,True,60
Ryan,2024-09-23,Credit One Visa ****6396,Fry's Food and Drug,Fry's Food and Drug,75.43,75.43,,Groceries,2821.62,75.43,75.43,0.00,simple,False,,expense_history_csv,Consolidated_Expense_History_20250622.csv,2025-07-18T12:32:53.413399,3.0,advanced_calculations_v3,exp_v3_001193,2024.00,9.00,3.00,False,False,False,True,40
Ryan,2024-09-24,Credit One Visa ****6396,Fry's Food and Drug,Fry's Food and Drug,86.40,86.40,,Groceries,2908.02,86.40,86.40,0.00,simple,False,,expense_history_csv,Consolidated_Expense_History_20250622.csv,2025-07-18T12:32:53.413399,3.0,advanced_calculations_v3,exp_v3_001194,2024.00,9.00,3.00,False,False,False,True,40
Ryan,2024-09-25,Credit One Visa ****6396,Fry's Food and Drug,Fry's Food and Drug,45.68,45.68,,Groceries,2953.70,45.68,45.68,0.00,simple,False,,expense_history_csv,Consolidated_Expense_History_20250622.csv,2025-07-18T12:32:53.413399,3.0,advanced_calculations_v3,exp_v3_001195,2024.00,9.00,3.00,False,False,False,True,40
Ryan,2024-09-26,Credit One Visa ****6396,WHOLEFDS CHR 10272 CHANDLER AZ,Whole Foods,30.43,30.43,,Groceries,2984.13,30.43,30.43,0.00,simple,False,,expense_history_csv,Consolidated_Expense_History_20250622.csv,2025-07-18T12:32:53.413399,3.0,advanced_calculations_v3,exp_v3_001196,2024.00,9.00,3.00,False,False,False,True,40
Ryan,2024-09-27,Credit One Visa ****6396,Fry's Food and Drug,Fry's Food and Drug,40.68,40.68,,Groceries,3024.81,40.68,40.68,0.00,simple,False,,expense_history_csv,Consolidated_Expense_History_20250622.csv,2025-07-18T12:32:53.413399,3.0,advanced_calculations_v3,exp_v3_001197,2024.00,9.00,3.00,False,False,False,True,40
Ryan,2024-09-27,Credit One Visa ****6396,Fry's Food and Drug,Fry's Food and Drug,37.64,37.64,,Groceries,3062.45,37.64,37.64,0.00,simple,False,,expense_history_csv,Consolidated_Expense_History_20250622.csv,2025-07-18T12:32:53.413399,3.0,advanced_calculations_v3,exp_v3_001198,2024.00,9.00,3.00,False,False,False,True,40
Ryan,2024-09-29,Credit One Visa ****6396,Fry's Food and Drug,Fry's Food and Drug,46.74,46.74,,Groceries,3109.19,46.74,46.74,0.00,simple,False,,expense_history_csv,Consolidated_Expense_History_20250622.csv,2025-07-18T12:32:53.413399,3.0,advanced_calculations_v3,exp_v3_001199,2024.00,9.00,3.00,False,False,False,True,40
Ryan,2024-07-02,Mercury ****XXXX,AMAZON MAR* 111-098587 SEATTLE WA,Amazon,53.89,53.89,No matching order found,Online purchase,3163.08,53.89,53.89,0.00,simple,False,,expense_history_csv,Consolidated_Expense_History_20250622.csv,2025-07-18T12:32:53.413399,3.0,advanced_calculations_v3,exp_v3_001200,2024.00,7.00,3.00,False,False,False,True,60
Ryan,2024-07-03,Mercury ****XXXX,AMAZON MKTPL*R71901H50 Amzn.com/billWA,Amazon,45.95,45.95,"Knee Pillow for Back Sleeping, Knee Pillow for Side Sleepers",Online purchase,3209.03,45.95,45.95,0.00,simple,False,,expense_history_csv,Consolidated_Expense_History_20250622.csv,2025-07-18T12:32:53.413399,3.0,advanced_calculations_v3,exp_v3_001201,2024.00,7.00,3.00,False,False,False,True,60
Ryan,2024-07-04,Mercury ****XXXX,AMAZON MKTPL*R74B50071 Amzn.com/billWA,Amazon,33.12,33.12,"Schylling NeeDoh Nice Cube, Fidget Spinners",Online purchase,3242.15,33.12,33.12,0.00,simple,False,,expense_history_csv,Consolidated_Expense_History_20250622.csv,2025-07-18T12:32:53.413399,3.0,advanced_calculations_v3,exp_v3_001202,2024.00,7.00,3.00,False,False,False,True,60
Ryan,2024-07-04,Mercury ****XXXX,GOOGLE *ONE AI Premium 650-253-0000 CA,Google,21.55,21.55,,Subscription,3263.70,21.55,21.55,0.00,simple,False,,expense_history_csv,Consolidated_Expense_History_20250622.csv,2025-07-18T12:32:53.413399,3.0,advanced_calculations_v3,exp_v3_001203,2024.00,7.00,3.00,False,False,False,True,40
Ryan,2024-07-06,Mercury ****XXXX,AMAZON MKTPL*R70B40I50 Amzn.com/billWA,Amazon,32.33,32.33,"100 Pack 3ml Syringes, Membrane Solutions Syringe Filters",Online purchase,3296.03,32.33,32.33,0.00,simple,False,,expense_history_csv,Consolidated_Expense_History_20250622.csv,2025-07-18T12:32:53.413399,3.0,advanced_calculations_v3,exp_v3_001204,2024.00,7.00,3.00,False,False,False,True,60
Ryan,2024-07-06,Mercury ****XXXX,Amazon.com*R77J818X1 Amzn.com/billWA,Amazon,16.64,16.64,100 Pack 3ml Syringes,Online purchase,3312.67,16.64,16.64,0.00,simple,False,,expense_history_csv,Consolidated_Expense_History_20250622.csv,2025-07-18T12:32:53.413399,3.0,advanced_calculations_v3,exp_v3_001205,2024.00,7.00,3.00,False,False,False,True,60
Ryan,2024-07-09,Mercury ****XXXX,Kindle Unltd*RY3KH2L11 888-802-3080 WA,Amazon Kindle,12.93,12.93,,Subscription,3325.60,12.93,12.93,0.00,simple,False,,expense_history_csv,Consolidated_Expense_History_20250622.csv,2025-07-18T12:32:53.413399,3.0,advanced_calculations_v3,exp_v3_001206,2024.00,7.00,3.00,False,False,False,True,40
Ryan,2024-07-09,Mercury ****XXXX,LS GLOBAL BIKES CHANDLER AZ,LS Global Bikes,48.50,48.50,,Retail,3374.10,48.50,48.50,0.00,simple,False,,expense_history_csv,Consolidated_Expense_History_20250622.csv,2025-07-18T12:32:53.413399,3.0,advanced_calculations_v3,exp_v3_001207,2024.00,7.00,3.00,False,False,False,True,40
Ryan,2024-07-10,Mercury ****XXXX,AMAZON MKTPL*RY6IL5JL2 Amzn.com/billWA,Amazon,14.33,14.33,"NOW Supplements, L-Lysine",Online purchase,3388.43,14.33,14.33,0.00,simple,False,,expense_history_csv,Consolidated_Expense_History_20250622.csv,2025-07-18T12:32:53.413399,3.0,advanced_calculations_v3,exp_v3_001208,2024.00,7.00,3.00,False,False,False,True,60
Ryan,2024-07-10,Mercury ****XXXX,AMAZON MKTPL*RY9CU33B1 Amzn.com/billWA,Amazon,7.44,7.44,"NOW Supplements, L-Tyrosine",Online purchase,3395.87,7.44,7.44,0.00,simple,False,,expense_history_csv,Consolidated_Expense_History_20250622.csv,2025-07-18T12:32:53.413399,3.0,advanced_calculations_v3,exp_v3_001209,2024.00,7.00,3.00,False,False,False,True,60
Ryan,2024-07-10,Mercury ****XXXX,AMZN Mktp US*RY2AQ53A2 Amzn.com/billWA,Amazon,26.62,26.62,Knee Pillow for Back Sleeping,Online purchase,3422.49,26.62,26.62,0.00,simple,False,,expense_history_csv,Consolidated_Expense_History_20250622.csv,2025-07-18T12:32:53.413399,3.0,advanced_calculations_v3,exp_v3_001210,2024.00,7.00,3.00,False,False,False,True,60
Ryan,2024-07-11,Mercury ****XXXX,AMAZON MKTPL*RY0EX7091 Amzn.com/billWA,Amazon,27.90,27.90,Membrane Solutions Syringe Filters,Online purchase,3450.39,27.90,27.90,0.00,simple,False,,expense_history_csv,Consolidated_Expense_History_20250622.csv,2025-07-18T12:32:53.413399,3.0,advanced_calculations_v3,exp_v3_001211,2024.00,7.00,3.00,False,False,False,True,60
Ryan,2024-07-11,Mercury ****XXXX,AMAZON MKTPL*RY0R63BI0 Amzn.com/billWA,Amazon,43.11,43.11,Physician's CHOICE Probiotics,Online purchase,3493.50,43.11,43.11,0.00,simple,False,,expense_history_csv,Consolidated_Expense_History_20250622.csv,2025-07-18T12:32:53.413399,3.0,advanced_calculations_v3,exp_v3_001212,2024.00,7.00,3.00,False,False,False,True,60
Ryan,2024-07-11,Mercury ****XXXX,AMAZON MKTPL*RY53U1EK1 Amzn.com/billWA,Amazon,49.73,49.73,"L-Serine Capsules, Nature's Bounty Zinc",Online purchase,3543.23,49.73,49.73,0.00,simple,False,,expense_history_csv,Consolidated_Expense_History_20250622.csv,2025-07-18T12:32:53.413399,3.0,advanced_calculations_v3,exp_v3_001213,2024.00,7.00,3.00,False,False,False,True,60
Ryan,2024-07-11,Mercury ****XXXX,Amazon.com*RY15490B1 Amzn.com/billWA,Amazon,9.68,9.68,Schylling NeeDoh Nice Cube,Online purchase,3552.91,9.68,9.68,0.00,simple,False,,expense_history_csv,Consolidated_Expense_History_20250622.csv,2025-07-18T12:32:53.413399,3.0,advanced_calculations_v3,exp_v3_001214,2024.00,7.00,3.00,False,False,False,True,60
Ryan,2024-07-14,Mercury ****XXXX,LEMSQZY* BUDGETSHEET SALT LAKE CITUT,Lemsqzy Budgetsheet,8.62,8.62,,Finance,3561.53,8.62,8.62,0.00,simple,False,,expense_history_csv,Consolidated_Expense_History_20250622.csv,2025-07-18T12:32:53.413399,3.0,advanced_calculations_v3,exp_v3_001215,2024.00,7.00,3.00,False,False,False,True,40
Ryan,2024-07-15,Mercury ****XXXX,Blizzard US728848830 Irvine CA,Blizzard Entertainment,100.00,100.00,,Gaming,3661.53,100.00,100.00,0.00,simple,False,,expense_history_csv,Consolidated_Expense_History_20250622.csv,2025-07-18T12:32:53.413399,3.0,advanced_calculations_v3,exp_v3_001216,2024.00,7.00,3.00,False,False,False,True,40
Ryan,2024-07-17,Mercury ****XXXX,Amazon.com*RS0G49G02 Amzn.com/billWA,Amazon,16.16,16.16,Knee Pillow for Back Sleeping,Online purchase,3677.69,16.16,16.16,0.00,simple,False,,expense_history_csv,Consolidated_Expense_History_20250622.csv,2025-07-18T12:32:53.413399,3.0,advanced_calculations_v3,exp_v3_001217,2024.00,7.00,3.00,False,False,False,True,60
Ryan,2024-07-20,Mercury ****XXXX,MAJESTIC TEMPE 7 ECOMM TEMPE AZ,Majestic Tempe 7,30.02,30.02,,Entertainment,3707.71,30.02,30.02,0.00,simple,False,,expense_history_csv,Consolidated_Expense_History_20250622.csv,2025-07-18T12:32:53.413399,3.0,advanced_calculations_v3,exp_v3_001218,2024.00,7.00,3.00,False,False,False,True,40
Ryan,2024-07-23,Mercury ****XXXX,AMAZON MKTPL*RJ8WA3VH1 Amzn.com/billWA,Amazon,18.32,18.32,Membrane Solutions Syringe Filters,Online purchase,3726.03,18.32,18.32,0.00,simple,False,,expense_history_csv,Consolidated_Expense_History_20250622.csv,2025-07-18T12:32:53.413399,3.0,advanced_calculations_v3,exp_v3_001219,2024.00,7.00,3.00,False,False,False,True,60
Ryan,2024-07-25,Mercury ****XXXX,CLAUDE.AI SUBSCRIPTION SAN FRANCISCOCA,Claude.ai,21.56,21.56,,Subscription,3747.59,21.56,21.56,0.00,simple,False,,expense_history_csv,Consolidated_Expense_History_20250622.csv,2025-07-18T12:32:53.413399,3.0,advanced_calculations_v3,exp_v3_001220,2024.00,7.00,3.00,False,False,False,True,40
Ryan,2024-07-26,Mercury ****XXXX,AMERICAN STRATEGIC INS ST. PETERSBURFL,American Strategic Insurance,213.53,213.53,Non-Amazon transaction,Insurance,3961.12,213.53,213.53,0.00,simple,False,,expense_history_csv,Consolidated_Expense_History_20250622.csv,2025-07-18T12:32:53.413399,3.0,advanced_calculations_v3,exp_v3_001221,2024.00,7.00,3.00,False,False,False,True,60
Ryan,2024-07-26,Mercury ****XXXX,CITY OF EVANSTON CONCE EVANSTON IL,City of Evanston,9.00,9.00,,Municipal Service,3970.12,9.00,9.00,0.00,simple,False,,expense_history_csv,Consolidated_Expense_History_20250622.csv,2025-07-18T12:32:53.413399,3.0,advanced_calculations_v3,exp_v3_001222,2024.00,7.00,3.00,False,False,False,True,40
Ryan,2024-07-26,Mercury ****XXXX,IN & OUT PANTRY MILWAUKEE WI,In & Out Pantry,105.92,105.92,,Grocery,4076.04,105.92,105.92,0.00,simple,False,,expense_history_csv,Consolidated_Expense_History_20250622.csv,2025-07-18T12:32:53.413399,3.0,advanced_calculations_v3,exp_v3_001223,2024.00,7.00,3.00,False,False,False,True,40
Ryan,2024-07-27,Mercury ****XXXX,AMAZON MARK* RV63220H0 SEATTLE WA,Amazon,48.46,48.46,LEGO Creator 3-in-1 Cozy House Building Kit,Online purchase,4124.50,48.46,48.46,0.00,simple,False,,expense_history_csv,Consolidated_Expense_History_20250622.csv,2025-07-18T12:32:53.413399,3.0,advanced_calculations_v3,exp_v3_001224,2024.00,7.00,3.00,False,False,False,True,60
Ryan,2024-07-28,Mercury ****XXXX,Amazon.com*RV5R983P1 Amzn.com/billWA,Amazon,10.23,10.23,Fidget Spinners,Online purchase,4134.73,10.23,10.23,0.00,simple,False,,expense_history_csv,Consolidated_Expense_History_20250622.csv,2025-07-18T12:32:53.413399,3.0,advanced_calculations_v3,exp_v3_001225,2024.00,7.00,3.00,False,False,False,True,60
Ryan,2024-07-28,Mercury ****XXXX,Amazon.com*RV82U8B02 Amzn.com/billWA,Amazon,23.45,23.45,Schylling NeeDoh Nice Cube,Online purchase,4158.18,23.45,23.45,0.00,simple,False,,expense_history_csv,Consolidated_Expense_History_20250622.csv,2025-07-18T12:32:53.413399,3.0,advanced_calculations_v3,exp_v3_001226,2024.00,7.00,3.00,False,False,False,True,60
Ryan,2024-07-30,Mercury ****XXXX,OPENAI *CHATGPT SUBSCR SAN FRANCISCOCA,OpenAI,21.56,21.56,,Subscription,4179.74,21.56,21.56,0.00,simple,False,,expense_history_csv,Consolidated_Expense_History_20250622.csv,2025-07-18T12:32:53.413399,3.0,advanced_calculations_v3,exp_v3_001227,2024.00,7.00,3.00,False,False,False,True,40
Ryan,2024-08-02,Mercury ****XXXX,HARKINS AZ MILLS PAY TEMPE AZ,Harkins Theaters,37.50,37.50,,Entertainment,4217.24,37.50,37.50,0.00,simple,False,,expense_history_csv,Consolidated_Expense_History_20250622.csv,2025-07-18T12:32:53.413399,3.0,advanced_calculations_v3,exp_v3_001228,2024.00,8.00,3.00,False,False,False,True,40
Ryan,2024-08-03,Mercury ****XXXX,PlaystationNetwork San Mateo CA,PlayStation Network,32.33,32.33,,Gaming,4249.57,32.33,32.33,0.00,simple,False,,expense_history_csv,Consolidated_Expense_History_20250622.csv,2025-07-18T12:32:53.413399,3.0,advanced_calculations_v3,exp_v3_001229,2024.00,8.00,3.00,False,False,False,True,40
Ryan,2024-08-04,Mercury ****XXXX,GOOGLE *ONE AI Premium 650-253-0000 CA,Google,21.55,21.55,,Subscription,4271.12,21.55,21.55,0.00,simple,False,,expense_history_csv,Consolidated_Expense_History_20250622.csv,2025-07-18T12:32:53.413399,3.0,advanced_calculations_v3,exp_v3_001230,2024.00,8.00,3.00,False,False,False,True,40
Ryan,2024-08-04,Mercury ****XXXX,PlayStation Network San Mateo CA,PlayStation Network,10.77,10.77,,Gaming,4281.89,10.77,10.77,0.00,simple,False,,expense_history_csv,Consolidated_Expense_History_20250622.csv,2025-07-18T12:32:53.413399,3.0,advanced_calculations_v3,exp_v3_001231,2024.00,8.00,3.00,False,False,False,True,40
Ryan,2024-08-04,Mercury ****XXXX,PlaystationNetwork San Mateo CA,PlayStation Network,27.80,27.80,,Gaming,4309.69,27.80,27.80,0.00,simple,False,,expense_history_csv,Consolidated_Expense_History_20250622.csv,2025-07-18T12:32:53.413399,3.0,advanced_calculations_v3,exp_v3_001232,2024.00,8.00,3.00,False,False,False,True,40
Ryan,2024-08-06,Mercury ****XXXX,FS *MYLIO SANTA BARBARACA,Mylio,107.79,107.79,,Subscription,4417.48,107.79,107.79,0.00,simple,False,,expense_history_csv,Consolidated_Expense_History_20250622.csv,2025-07-18T12:32:53.413399,3.0,advanced_calculations_v3,exp_v3_001233,2024.00,8.00,3.00,False,False,False,True,40
Ryan,2024-08-07,Mercury ****XXXX,AMAZON MKTPL*RF9C087N1 Amzn.com/billWA,Amazon,13.30,13.30,Aromatherapy Sensual Massage Oil,Online purchase,4430.78,13.30,13.30,0.00,simple,False,,expense_history_csv,Consolidated_Expense_History_20250622.csv,2025-07-18T12:32:53.413399,3.0,advanced_calculations_v3,exp_v3_001234,2024.00,8.00,3.00,False,False,False,True,60
Ryan,2024-08-07,Mercury ****XXXX,AMAZON.COM*RF9CF09B1 SEATTLE WA,Amazon,18.30,18.30,Aromatherapy Sensual Massage Oil,Online purchase,4449.08,18.30,18.30,0.00,simple,False,,expense_history_csv,Consolidated_Expense_History_20250622.csv,2025-07-18T12:32:53.413399,3.0,advanced_calculations_v3,exp_v3_001235,2024.00,8.00,3.00,False,False,False,True,60
Ryan,2024-08-09,Mercury ****XXXX,BLIZZARD *US731211476 9499551380 CA,Blizzard Entertainment,16.17,16.17,,Gaming,4465.25,16.17,16.17,0.00,simple,False,,expense_history_csv,Consolidated_Expense_History_20250622.csv,2025-07-18T12:32:53.413399,3.0,advanced_calculations_v3,exp_v3_001236,2024.00,8.00,3.00,False,False,False,True,40
Ryan,2024-08-10,Mercury ****XXXX,AMAZON MKTPL*RM5UX8MU2 Amzn.com/billWA,Amazon,15.08,15.08,The Disruptors (Digital Purchase),Online purchase,4480.33,15.08,15.08,1.00,simple,False,Mathematical operation: (Digital Purchase),expense_history_csv,Consolidated_Expense_History_20250622.csv,2025-07-18T12:32:53.413399,3.0,advanced_calculations_v3,exp_v3_001237,2024.00,8.00,3.00,False,False,False,True,60
Ryan,2024-08-11,Mercury ****XXXX,AMAZON MKTPL*RM0B45MF0 Amzn.com/billWA,Amazon,16.36,16.36,Gotu Kola Capsules,Online purchase,4496.69,16.36,16.36,0.00,simple,False,,expense_history_csv,Consolidated_Expense_History_20250622.csv,2025-07-18T12:32:53.413399,3.0,advanced_calculations_v3,exp_v3_001238,2024.00,8.00,3.00,False,False,False,True,60
Ryan,2024-08-11,Mercury ****XXXX,HARKINS CHANDLER F PAY CHANDLER AZ,Harkins Theaters,14.75,14.75,,Entertainment,4511.44,14.75,14.75,0.00,simple,False,,expense_history_csv,Consolidated_Expense_History_20250622.csv,2025-07-18T12:32:53.413399,3.0,advanced_calculations_v3,exp_v3_001239,2024.00,8.00,3.00,False,False,False,True,40
Ryan,2024-08-13,Mercury ****XXXX,AMAZON MKTPL*RM5HW4IP2 Amzn.com/billWA,Amazon,31.26,31.26,"Care Touch 10mL Syringes, 100 Pack 3ml Syringes",Online purchase,4542.70,31.26,31.26,0.00,simple,False,,expense_history_csv,Consolidated_Expense_History_20250622.csv,2025-07-18T12:32:53.413399,3.0,advanced_calculations_v3,exp_v3_001240,2024.00,8.00,3.00,False,False,False,True,60
Ryan,2024-08-14,Mercury ****XXXX,LEMSQZY* BUDGETSHEET SALT LAKE CITUT,Lemsqzy Budgetsheet,8.62,8.62,,Finance,4551.32,8.62,8.62,0.00,simple,False,,expense_history_csv,Consolidated_Expense_History_20250622.csv,2025-07-18T12:32:53.413399,3.0,advanced_calculations_v3,exp_v3_001241,2024.00,8.00,3.00,False,False,False,True,40
Ryan,2024-08-14,Mercury ****XXXX,Microsoft*Store Redmond WA,Microsoft Store,1.04,1.04,,Online purchase,4552.36,1.04,1.04,0.00,simple,False,,expense_history_csv,Consolidated_Expense_History_20250622.csv,2025-07-18T12:32:53.413399,3.0,advanced_calculations_v3,exp_v3_001242,2024.00,8.00,3.00,False,False,False,True,40
Ryan,2024-08-15,Mercury ****XXXX,AMAZON MARK* RU85E8LR0 SEATTLE WA,Amazon,50.66,50.66,Logitech MX Anywhere 3S for Mac (Pale Grey),Online purchase,4603.02,50.66,50.66,1.00,simple,False,Mathematical operation: (Pale Grey),expense_history_csv,Consolidated_Expense_History_20250622.csv,2025-07-18T12:32:53.413399,3.0,advanced_calculations_v3,exp_v3_001243,2024.00,8.00,3.00,False,False,False,True,60
Ryan,2024-08-15,Mercury ****XXXX,AMAZON MKTPL*RU2G45ED2 Amzn.com/billWA,Amazon,41.06,41.06,Logitech MX Anywhere 3S for Mac (Pale Grey),Online purchase,4644.08,41.06,41.06,1.00,simple,False,Mathematical operation: (Pale Grey),expense_history_csv,Consolidated_Expense_History_20250622.csv,2025-07-18T12:32:53.413399,3.0,advanced_calculations_v3,exp_v3_001244,2024.00,8.00,3.00,False,False,False,True,60
Ryan,2024-08-25,Mercury ****XXXX,AMAZON MKTPL*R411X8811 Amzn.com/billWA,Amazon,19.35,19.35,Care Touch 10mL Syringes (100 Count),Online purchase,4663.43,19.35,19.35,1.00,simple,False,Mathematical operation: (100 Count),expense_history_csv,Consolidated_Expense_History_20250622.csv,2025-07-18T12:32:53.413399,3.0,advanced_calculations_v3,exp_v3_001245,2024.00,8.00,3.00,False,False,False,True,60
Ryan,2024-08-25,Mercury ****XXXX,CLAUDE.AI SUBSCRIPTION SAN FRANCISCOCA,Claude.ai,21.56,21.56,,Subscription,4684.99,21.56,21.56,0.00,simple,False,,expense_history_csv,Consolidated_Expense_History_20250622.csv,2025-07-18T12:32:53.413399,3.0,advanced_calculations_v3,exp_v3_001246,2024.00,8.00,3.00,False,False,False,True,40
Ryan,2024-08-26,Mercury ****XXXX,AMAZON MARK* RK5XZ33T2 SEATTLE WA,Amazon,12.93,12.93,The Disruptors (Digital Purchase),Online purchase,4697.92,12.93,12.93,1.00,simple,False,Mathematical operation: (Digital Purchase),expense_history_csv,Consolidated_Expense_History_20250622.csv,2025-07-18T12:32:53.413399,3.0,advanced_calculations_v3,exp_v3_001247,2024.00,8.00,3.00,False,False,False,True,60
Ryan,2024-08-26,Mercury ****XXXX,PAYPAL *PYPL PAYIN4 8882211161 CA,PayPal,10.71,10.71,,Online purchase,4708.63,10.71,10.71,0.00,simple,False,,expense_history_csv,Consolidated_Expense_History_20250622.csv,2025-07-18T12:32:53.413399,3.0,advanced_calculations_v3,exp_v3_001248,2024.00,8.00,3.00,False,False,False,True,40
Ryan,2024-08-27,Mercury ****XXXX,AMAZON MARK* RK4H78132 SEATTLE WA,Amazon,43.01,43.01,No matching order found,Online purchase,4751.64,43.01,43.01,0.00,simple,False,,expense_history_csv,Consolidated_Expense_History_20250622.csv,2025-07-18T12:32:53.413399,3.0,advanced_calculations_v3,exp_v3_001249,2024.00,8.00,3.00,False,False,False,True,60
Ryan,2024-08-27,Mercury ****XXXX,AMAZON MKTPL*R435Q3990 Amzn.com/billWA,Amazon,55.17,55.17,"Abigail (Digital), Alice In Wonderland (Digital), ""The Disruptors"" (Digital)",Online purchase,4806.81,55.17,55.17,3.00,complex,False,Mathematical operation: (Digital); Mathematical operation: (Digital); Mathematical operation: (Digital),expense_history_csv,Consolidated_Expense_History_20250622.csv,2025-07-18T12:32:53.413399,3.0,advanced_calculations_v3,exp_v3_001250,2024.00,8.00,3.00,True,False,False,True,60
Ryan,2024-08-27,Mercury ****XXXX,AMAZON MKTPL*R43YP69E0 Amzn.com/billWA,Amazon,132.75,132.75,"Multiple Supplements (L-Serine, Zinc, L-Lysine, L-Tyrosine, Probiotics)",Online purchase,4939.56,132.75,132.75,1.00,simple,False,"Mathematical operation: (L-Serine, Zinc, L-Lysine, L-Tyrosine, Probiotics)",expense_history_csv,Consolidated_Expense_History_20250622.csv,2025-07-18T12:32:53.413399,3.0,advanced_calculations_v3,exp_v3_001251,2024.00,8.00,3.00,False,False,False,True,60
Ryan,2024-08-27,Mercury ****XXXX,BLIZZARD *US733420918 9499551380 CA,Blizzard Entertainment,97.10,97.10,,Gaming,5036.66,97.10,97.10,0.00,simple,False,,expense_history_csv,Consolidated_Expense_History_20250622.csv,2025-07-18T12:32:53.413399,3.0,advanced_calculations_v3,exp_v3_001252,2024.00,8.00,3.00,False,False,False,True,40
Ryan,2024-08-27,Mercury ****XXXX,PAYPAL *STEAM GAMES 4259522985 WA,Steam,3.20,3.20,,Gaming,5039.86,3.20,3.20,0.00,simple,False,,expense_history_csv,Consolidated_Expense_History_20250622.csv,2025-07-18T12:32:53.413399,3.0,advanced_calculations_v3,exp_v3_001253,2024.00,8.00,3.00,False,False,False,True,40
Ryan,2024-08-28,Mercury ****XXXX,AMAZON MKTPL*RK28F55Y2 Amzn.com/billWA,Amazon,21.71,21.71,DECORA Googly Eyes,Online purchase,5061.57,21.71,21.71,0.00,simple,False,,expense_history_csv,Consolidated_Expense_History_20250622.csv,2025-07-18T12:32:53.413399,3.0,advanced_calculations_v3,exp_v3_001254,2024.00,8.00,3.00,False,False,False,True,60
Ryan,2024-08-30,Mercury ****XXXX,OPENAI *CHATGPT SUBSCR SAN FRANCISCOCA,OpenAI,21.56,21.56,,Subscription,5083.13,21.56,21.56,0.00,simple,False,,expense_history_csv,Consolidated_Expense_History_20250622.csv,2025-07-18T12:32:53.413399,3.0,advanced_calculations_v3,exp_v3_001255,2024.00,8.00,3.00,False,False,False,True,40
Ryan,2024-09-01,Mercury ****XXXX,AMAZON MARK* ZT9JN8FS2 SEATTLE WA,Amazon,96.92,96.92,No matching order found,Online purchase,5180.05,96.92,96.92,0.00,simple,False,,expense_history_csv,Consolidated_Expense_History_20250622.csv,2025-07-18T12:32:53.413399,3.0,advanced_calculations_v3,exp_v3_001256,2024.00,9.00,3.00,False,False,False,True,60
Ryan,2024-09-02,Mercury ****XXXX,FS *MYLIO SANTA BARBARACA,Mylio,107.79,107.79,,Subscription,5287.84,107.79,107.79,0.00,simple,False,,expense_history_csv,Consolidated_Expense_History_20250622.csv,2025-07-18T12:32:53.413399,3.0,advanced_calculations_v3,exp_v3_001257,2024.00,9.00,3.00,False,False,False,True,40
Ryan,2024-09-04,Mercury ****XXXX,GOOGLE *ONE AI Premium 650-253-0000 CA,Google,21.55,21.55,,Subscription,5309.39,21.55,21.55,0.00,simple,False,,expense_history_csv,Consolidated_Expense_History_20250622.csv,2025-07-18T12:32:53.413399,3.0,advanced_calculations_v3,exp_v3_001258,2024.00,9.00,3.00,False,False,False,True,40
Ryan,2024-09-08,Mercury ****XXXX,AMAZON MKTPL*Z88NU1462 Amzn.com/billWA,Amazon,35.38,35.38,Wild One Dog Poop Bags,Online purchase,5344.77,35.38,35.38,0.00,simple,False,,expense_history_csv,Consolidated_Expense_History_20250622.csv,2025-07-18T12:32:53.413399,3.0,advanced_calculations_v3,exp_v3_001259,2024.00,9.00,3.00,False,False,False,True,60
Ryan,2024-09-08,Mercury ****XXXX,AMAZON MKTPL*ZT45M2I40 Amzn.com/billWA,Amazon,33.40,33.40,DECORA Googly Eyes,Online purchase,5378.17,33.40,33.40,0.00,simple,False,,expense_history_csv,Consolidated_Expense_History_20250622.csv,2025-07-18T12:32:53.413399,3.0,advanced_calculations_v3,exp_v3_001260,2024.00,9.00,3.00,False,False,False,True,60
Ryan,2024-09-09,Mercury ****XXXX,Kindle Unltd*Z87753L60 888-802-3080 WA,Amazon Kindle,12.93,12.93,,Subscription,5391.10,12.93,12.93,0.00,simple,False,,expense_history_csv,Consolidated_Expense_History_20250622.csv,2025-07-18T12:32:53.413399,3.0,advanced_calculations_v3,exp_v3_001261,2024.00,9.00,3.00,False,False,False,True,40
Ryan,2024-09-09,Mercury ****XXXX,PAYPAL *PYPL PAYIN4 8882211161 CA,PayPal,10.71,10.71,,Online purchase,5401.81,10.71,10.71,0.00,simple,False,,expense_history_csv,Consolidated_Expense_History_20250622.csv,2025-07-18T12:32:53.413399,3.0,advanced_calculations_v3,exp_v3_001262,2024.00,9.00,3.00,False,False,False,True,40
Ryan,2024-09-13,Mercury ****XXXX,AMAZON MARK* V759P2Z23 SEATTLE WA,Amazon,28.00,28.00,Wild One Dog Poop Bags,Online purchase,5429.81,28.00,28.00,0.00,simple,False,,expense_history_csv,Consolidated_Expense_History_20250622.csv,2025-07-18T12:32:53.413399,3.0,advanced_calculations_v3,exp_v3_001263,2024.00,9.00,3.00,False,False,False,True,60
Ryan,2024-09-15,Mercury ****XXXX,AMAZON MARK* AG4ZO3IE3 SEATTLE WA,Amazon,15.46,15.46,No matching order found,Online purchase,5445.27,15.46,15.46,0.00,simple,False,,expense_history_csv,Consolidated_Expense_History_20250622.csv,2025-07-18T12:32:53.413399,3.0,advanced_calculations_v3,exp_v3_001264,2024.00,9.00,3.00,False,False,False,True,60
Ryan,2024-09-15,Mercury ****XXXX,AMAZON MKTPL*N19TB5SD3 Amzn.com/billWA,Amazon,23.69,23.69,"Gotu Kola Capsules, Membrane Solutions Syringe Filters",Online purchase,5468.96,23.69,23.69,0.00,simple,False,,expense_history_csv,Consolidated_Expense_History_20250622.csv,2025-07-18T12:32:53.413399,3.0,advanced_calculations_v3,exp_v3_001265,2024.00,9.00,3.00,False,False,False,True,60
Ryan,2024-09-19,Mercury ****XXXX,AMAZON MARK* PL3FN4OJ3 SEATTLE WA,Amazon,64.67,64.67,Logitech MX Anywhere 3S for Mac (Space Grey),Online purchase,5533.63,64.67,64.67,1.00,simple,False,Mathematical operation: (Space Grey),expense_history_csv,Consolidated_Expense_History_20250622.csv,2025-07-18T12:32:53.413399,3.0,advanced_calculations_v3,exp_v3_001266,2024.00,9.00,3.00,False,False,False,True,60
Ryan,2024-09-19,Mercury ****XXXX,AMAZON MKTPL*VB5NW09M3 Amzn.com/billWA,Amazon,28.66,28.66,Keychron M3 Mini 4K Wireless Mouse,Online purchase,5562.29,28.66,28.66,0.00,simple,False,,expense_history_csv,Consolidated_Expense_History_20250622.csv,2025-07-18T12:32:53.413399,3.0,advanced_calculations_v3,exp_v3_001267,2024.00,9.00,3.00,False,False,False,True,60
Ryan,2024-09-21,Mercury ****XXXX,AMAZON MARKETPLACE,Amazon,32.24,32.24,"Crazy Aaron's Thinking Putty, Schylling NeeDoh Nice Cube",Online purchase,5594.53,32.24,32.24,0.00,simple,False,,expense_history_csv,Consolidated_Expense_History_20250622.csv,2025-07-18T12:32:53.413399,3.0,advanced_calculations_v3,exp_v3_001268,2024.00,9.00,3.00,False,False,False,True,60
Ryan,2024-09-21,Mercury ****XXXX,AMAZON MARKETPLACE,Amazon,54.20,54.20,"Fidget Spinners, Mr. Pen Kneaded Eraser, Massage Oil, Knee Pillow",Online purchase,5648.73,54.20,54.20,0.00,simple,False,,expense_history_csv,Consolidated_Expense_History_20250622.csv,2025-07-18T12:32:53.413399,3.0,advanced_calculations_v3,exp_v3_001269,2024.00,9.00,3.00,False,False,False,True,60
Ryan,2024-09-21,Mercury ****XXXX,AMAZON RETAIL,Amazon,51.73,51.73,"LEGO Creator 3-in-1 Cozy House, Crazy Aaron's Thinking Putty",Online purchase,5700.46,51.73,51.73,0.00,simple,False,,expense_history_csv,Consolidated_Expense_History_20250622.csv,2025-07-18T12:32:53.413399,3.0,advanced_calculations_v3,exp_v3_001270,2024.00,9.00,3.00,False,False,False,True,60
Ryan,2024-09-22,Mercury ****XXXX,AMAZON MARKETPLACE,Amazon,53.18,53.18,"Shower Curtain Hooks, Water Filter Dispenser, Shower Curtain",Online purchase,5753.64,53.18,53.18,0.00,simple,False,,expense_history_csv,Consolidated_Expense_History_20250622.csv,2025-07-18T12:32:53.413399,3.0,advanced_calculations_v3,exp_v3_001271,2024.00,9.00,3.00,False,False,False,True,60
Ryan,2024-09-22,Mercury ****XXXX,AMAZON MARKETPLACE,Amazon,47.73,47.73,"Contour Legacy Leg Pillow (2 Pack), ComfiLife Knee Pillow",Online purchase,5801.37,47.73,47.73,1.00,simple,False,Mathematical operation: (2 Pack),expense_history_csv,Consolidated_Expense_History_20250622.csv,2025-07-18T12:32:53.413399,3.0,advanced_calculations_v3,exp_v3_001272,2024.00,9.00,3.00,False,False,False,True,60
Ryan,2024-09-22,Mercury ****XXXX,AMZN Mktp US,Amazon,43.11,43.11,"Digital Movies: ""The Land Before Time,"" ""An American Tail,"" ""An American Tail: Fievel Goes West""",Online purchase,5844.48,43.11,43.11,0.00,simple,False,,expense_history_csv,Consolidated_Expense_History_20250622.csv,2025-07-18T12:32:53.413399,3.0,advanced_calculations_v3,exp_v3_001273,2024.00,9.00,3.00,False,False,False,True,60
Ryan,2024-07-02,Wells Fargo Autograph Visa ****5037,CHEVRON 0388242 TEMPE AZ,Chevron,42.68,42.68,,Auto & Transport,5887.16,42.68,42.68,0.00,simple,False,,expense_history_csv,Consolidated_Expense_History_20250622.csv,2025-07-18T12:32:53.413399,3.0,advanced_calculations_v3,exp_v3_001274,2024.00,7.00,3.00,False,False,False,True,40
Ryan,2024-07-02,Wells Fargo Autograph Visa ****5037,PETSMART # 1017 CHANDLER AZ,PetSmart,2.15,2.15,,Pets,5889.31,2.15,2.15,0.00,simple,False,,expense_history_csv,Consolidated_Expense_History_20250622.csv,2025-07-18T12:32:53.413399,3.0,advanced_calculations_v3,exp_v3_001275,2024.00,7.00,3.00,False,False,False,True,40
Ryan,2024-07-03,Wells Fargo Autograph Visa ****5037,FRYS-FOOD-DRG #051 CHANDLER AZ,Fry's Food and Drug,55.96,55.96,,Groceries,5945.27,55.96,55.96,0.00,simple,False,,expense_history_csv,Consolidated_Expense_History_20250622.csv,2025-07-18T12:32:53.413399,3.0,advanced_calculations_v3,exp_v3_001276,2024.00,7.00,3.00,False,False,False,True,40
Ryan,2024-07-08,Wells Fargo Autograph Visa ****5037,BLUE WASABI SUSHI & MARTIGILBERT AZ,Blue Wasabi Sushi,116.78,116.78,,Dining & Drinks,6062.05,116.78,116.78,0.00,simple,False,,expense_history_csv,Consolidated_Expense_History_20250622.csv,2025-07-18T12:32:53.413399,3.0,advanced_calculations_v3,exp_v3_001277,2024.00,7.00,3.00,False,False,False,True,40
Ryan,2024-07-08,Wells Fargo Autograph Visa ****5037,CIRCLE K 00781 MAYER AZ,Circle K,7.83,7.83,,Shopping,6069.88,7.83,7.83,0.00,simple,False,,expense_history_csv,Consolidated_Expense_History_20250622.csv,2025-07-18T12:32:53.413399,3.0,advanced_calculations_v3,exp_v3_001278,2024.00,7.00,3.00,False,False,False,True,40
Ryan,2024-07-08,Wells Fargo Autograph Visa ****5037,FARM PROVISIONS PRESCOTT AZ,Farm Provisions,126.31,126.31,,Dining & Drinks,6196.19,126.31,126.31,0.00,simple,False,,expense_history_csv,Consolidated_Expense_History_20250622.csv,2025-07-18T12:32:53.413399,3.0,advanced_calculations_v3,exp_v3_001279,2024.00,7.00,3.00,False,False,False,True,40
Ryan,2024-07-08,Wells Fargo Autograph Visa ****5037,FRYS FUEL # 7096 PHOENIX AZ,Fry's Fuel,29.71,29.71,,Auto & Transport,6225.90,29.71,29.71,0.00,simple,False,,expense_history_csv,Consolidated_Expense_History_20250622.csv,2025-07-18T12:32:53.413399,3.0,advanced_calculations_v3,exp_v3_001280,2024.00,7.00,3.00,False,False,False,True,40
Ryan,2024-07-08,Wells Fargo Autograph Visa ****5037,FRYS-FOOD-DRG #051 CHANDLER AZ,Fry's Food and Drug,64.81,64.81,,Groceries,6290.71,64.81,64.81,0.00,simple,False,,expense_history_csv,Consolidated_Expense_History_20250622.csv,2025-07-18T12:32:53.413399,3.0,advanced_calculations_v3,exp_v3_001281,2024.00,7.00,3.00,False,False,False,True,40
Ryan,2024-07-08,Wells Fargo Autograph Visa ****5037,GILLIGANS MAYER MARKET MAYER AZ,Gilligan's Market,11.93,11.93,,Shopping,6302.64,11.93,11.93,0.00,simple,False,,expense_history_csv,Consolidated_Expense_History_20250622.csv,2025-07-18T12:32:53.413399,3.0,advanced_calculations_v3,exp_v3_001282,2024.00,7.00,3.00,False,False,False,True,40
Ryan,2024-07-13,Wells Fargo Autograph Visa ****5037,5GUYS 0576 QSR CHANDLER AZ,Five Guys,24.95,24.95,,Dining & Drinks,6327.59,24.95,24.95,0.00,simple,False,,expense_history_csv,Consolidated_Expense_History_20250622.csv,2025-07-18T12:32:53.413399,3.0,advanced_calculations_v3,exp_v3_001283,2024.00,7.00,3.00,False,False,False,True,40
Ryan,2024-07-19,Wells Fargo Autograph Visa ****5037,PICAZZOS HEALTHY ITALI TEMPE AZ,Picazzo's,50.66,50.66,,Dining & Drinks,6378.25,50.66,50.66,0.00,simple,False,,expense_history_csv,Consolidated_Expense_History_20250622.csv,2025-07-18T12:32:53.413399,3.0,advanced_calculations_v3,exp_v3_001284,2024.00,7.00,3.00,False,False,False,True,40
Ryan,2024-07-21,Wells Fargo Autograph Visa ****5037,IN-N-OUT CHANDLER 2 CHANDLER AZ,In-N-Out,13.89,13.89,,Dining & Drinks,6392.14,13.89,13.89,0.00,simple,False,,expense_history_csv,Consolidated_Expense_History_20250622.csv,2025-07-18T12:32:53.413399,3.0,advanced_calculations_v3,exp_v3_001285,2024.00,7.00,3.00,False,False,False,True,40
Ryan,2024-07-21,Wells Fargo Autograph Visa ****5037,LITTLE SZECHUAN TEMPE AZ,Little Szechuan,35.59,35.59,,Dining & Drinks,6427.73,35.59,35.59,0.00,simple,False,,expense_history_csv,Consolidated_Expense_History_20250622.csv,2025-07-18T12:32:53.413399,3.0,advanced_calculations_v3,exp_v3_001286,2024.00,7.00,3.00,False,False,False,True,40
Ryan,2024-07-21,Wells Fargo Autograph Visa ****5037,Majestic Tempe 7 Tempe AZ,Majestic Tempe 7,38.35,38.35,,Entertainment & Rec.,6466.08,38.35,38.35,0.00,simple,False,,expense_history_csv,Consolidated_Expense_History_20250622.csv,2025-07-18T12:32:53.413399,3.0,advanced_calculations_v3,exp_v3_001287,2024.00,7.00,3.00,False,False,False,True,40
Ryan,2024-07-23,Wells Fargo Autograph Visa ****5037,KEYMELOCKSMITHS.COM HTTPSKEY.ME NJ,KeyMe Locksmiths,6.50,6.50,,Uncategorized,6472.58,6.50,6.50,0.00,simple,False,,expense_history_csv,Consolidated_Expense_History_20250622.csv,2025-07-18T12:32:53.413399,3.0,advanced_calculations_v3,exp_v3_001288,2024.00,7.00,3.00,False,False,False,True,40
Ryan,2024-07-27,Wells Fargo Autograph Visa ****5037,ACTION DIGITAL MILWAUKEE WI,Action Digital,8.63,8.63,,Uncategorized,6481.21,8.63,8.63,0.00,simple,False,,expense_history_csv,Consolidated_Expense_History_20250622.csv,2025-07-18T12:32:53.413399,3.0,advanced_calculations_v3,exp_v3_001289,2024.00,7.00,3.00,False,False,False,True,40
Ryan,2024-07-27,Wells Fargo Autograph Visa ****5037,Netflix 1 8445052993 CA,Netflix,24.78,24.78,,Entertainment & Rec.,6505.99,24.78,24.78,0.00,simple,False,,expense_history_csv,Consolidated_Expense_History_20250622.csv,2025-07-18T12:32:53.413399,3.0,advanced_calculations_v3,exp_v3_001290,2024.00,7.00,3.00,False,False,False,True,40
Ryan,2024-07-28,Wells Fargo Autograph Visa ****5037,AVIS RENT-A-CAR MILWAUKEE WI,Avis,346.73,346.73,,Auto & Transport,6852.72,346.73,346.73,0.00,simple,False,,expense_history_csv,Consolidated_Expense_History_20250622.csv,2025-07-18T12:32:53.413399,3.0,advanced_calculations_v3,exp_v3_001291,2024.00,7.00,3.00,False,False,False,True,40
Ryan,2024-07-28,Wells Fargo Autograph Visa ****5037,BP#9652884WELCOME MART # MILWAUKEE WI,BP,37.10,37.10,,Auto & Transport,6889.82,37.10,37.10,0.00,simple,False,,expense_history_csv,Consolidated_Expense_History_20250622.csv,2025-07-18T12:32:53.413399,3.0,advanced_calculations_v3,exp_v3_001292,2024.00,7.00,3.00,False,False,False,True,40
Ryan,2024-07-28,Wells Fargo Autograph Visa ****5037,BP#9652884WELCOME MART # MILWAUKEE WI,BP,18.96,18.96,,Auto & Transport,6908.78,18.96,18.96,0.00,simple,False,,expense_history_csv,Consolidated_Expense_History_20250622.csv,2025-07-18T12:32:53.413399,3.0,advanced_calculations_v3,exp_v3_001293,2024.00,7.00,3.00,False,False,False,True,40
Ryan,2024-08-02,Wells Fargo Autograph Visa ****5037,ESSENTIALLY YOU CHANDLER AZ,Essentially You,58.75,58.75,,Shopping,6967.53,58.75,58.75,0.00,simple,False,,expense_history_csv,Consolidated_Expense_History_20250622.csv,2025-07-18T12:32:53.413399,3.0,advanced_calculations_v3,exp_v3_001294,2024.00,8.00,3.00,False,False,False,True,40
Ryan,2024-08-03,Wells Fargo Autograph Visa ****5037,CHON THAI FOOD CHANDLER AZ,Chon Thai Food,51.16,51.16,,Dining & Drinks,7018.69,51.16,51.16,0.00,simple,False,,expense_history_csv,Consolidated_Expense_History_20250622.csv,2025-07-18T12:32:53.413399,3.0,advanced_calculations_v3,exp_v3_001295,2024.00,8.00,3.00,False,False,False,True,40
Ryan,2024-08-03,Wells Fargo Autograph Visa ****5037,CVS/PHARMACY #09328 SCOTTSDALE AZ,CVS,10.36,10.36,,Shopping,7029.05,10.36,10.36,0.00,simple,False,,expense_history_csv,Consolidated_Expense_History_20250622.csv,2025-07-18T12:32:53.413399,3.0,advanced_calculations_v3,exp_v3_001296,2024.00,8.00,3.00,False,False,False,True,40
Ryan,2024-08-03,Wells Fargo Autograph Visa ****5037,FRYS FUEL #7005 SCOTTSDALE AZ,Fry's Fuel,30.23,30.23,,Auto & Transport,7059.28,30.23,30.23,0.00,simple,False,,expense_history_csv,Consolidated_Expense_History_20250622.csv,2025-07-18T12:32:53.413399,3.0,advanced_calculations_v3,exp_v3_001297,2024.00,8.00,3.00,False,False,False,True,40
Ryan,2024-08-03,Wells Fargo Autograph Visa ****5037,HARKINS AZ MILLS TEMPE AZ,Harkins Theaters,23.00,23.00,,Entertainment & Rec.,7082.28,23.00,23.00,0.00,simple,False,,expense_history_csv,Consolidated_Expense_History_20250622.csv,2025-07-18T12:32:53.413399,3.0,advanced_calculations_v3,exp_v3_001298,2024.00,8.00,3.00,False,False,False,True,40
Ryan,2024-08-03,Wells Fargo Autograph Visa ****5037,HULA'S MODERN TIKI SCOTT SCOTTSDALE AZ,Hula's Modern Tiki,102.88,102.88,,Dining & Drinks,7185.16,102.88,102.88,0.00,simple,False,,expense_history_csv,Consolidated_Expense_History_20250622.csv,2025-07-18T12:32:53.413399,3.0,advanced_calculations_v3,exp_v3_001299,2024.00,8.00,3.00,False,False,False,True,40
Ryan,2024-08-03,Wells Fargo Autograph Visa ****5037,NINJA JAPANESE RESTAU CHANDLER AZ,Ninja Japanese Restaurant,24.85,24.85,,Dining & Drinks,7210.01,24.85,24.85,0.00,simple,False,,expense_history_csv,Consolidated_Expense_History_20250622.csv,2025-07-18T12:32:53.413399,3.0,advanced_calculations_v3,exp_v3_001300,2024.00,8.00,3.00,False,False,False,True,40
Ryan,2024-08-04,Wells Fargo Autograph Visa ****5037,CHEVRON 0209999 CHANDLER AZ,Chevron,35.19,35.19,,Auto & Transport,7245.20,35.19,35.19,0.00,simple,False,,expense_history_csv,Consolidated_Expense_History_20250622.csv,2025-07-18T12:32:53.413399,3.0,advanced_calculations_v3,exp_v3_001301,2024.00,8.00,3.00,False,False,False,True,40
Ryan,2024-08-10,Wells Fargo Autograph Visa ****5037,MANUEL'S #7 TEMPE AZ,Manuel's,77.32,77.32,,Dining & Drinks,7322.52,77.32,77.32,0.00,simple,False,,expense_history_csv,Consolidated_Expense_History_20250622.csv,2025-07-18T12:32:53.413399,3.0,advanced_calculations_v3,exp_v3_001302,2024.00,8.00,3.00,False,False,False,True,40
Ryan,2024-08-11,Wells Fargo Autograph Visa ****5037,DD DOORDASH LITTLESZE 855-973-1040 CA,DoorDash,38.40,38.40,,Dining & Drinks,7360.92,38.40,38.40,0.00,simple,False,,expense_history_csv,Consolidated_Expense_History_20250622.csv,2025-07-18T12:32:53.413399,3.0,advanced_calculations_v3,exp_v3_001303,2024.00,8.00,3.00,False,False,False,True,40
Ryan,2024-08-11,Wells Fargo Autograph Visa ****5037,HARKINS CHANDLER FASHON CHANDLER AZ,Harkins Theaters,14.50,14.50,,Entertainment & Rec.,7375.42,14.50,14.50,0.00,simple,False,,expense_history_csv,Consolidated_Expense_History_20250622.csv,2025-07-18T12:32:53.413399,3.0,advanced_calculations_v3,exp_v3_001304,2024.00,8.00,3.00,False,False,False,True,40
Ryan,2024-08-11,Wells Fargo Autograph Visa ****5037,HARKINS CHANDLER FASHON CHANDLER AZ,Harkins Theaters,14.50,14.50,,Entertainment & Rec.,7389.92,14.50,14.50,0.00,simple,False,,expense_history_csv,Consolidated_Expense_History_20250622.csv,2025-07-18T12:32:53.413399,3.0,advanced_calculations_v3,exp_v3_001305,2024.00,8.00,3.00,False,False,False,True,40
Ryan,2024-08-16,Wells Fargo Autograph Visa ****5037,ETOLLAVIS U76385251 800-482-0159 WI,E-Toll,11.25,11.25,,Auto & Transport,7401.17,11.25,11.25,0.00,simple,False,,expense_history_csv,Consolidated_Expense_History_20250622.csv,2025-07-18T12:32:53.413399,3.0,advanced_calculations_v3,exp_v3_001306,2024.00,8.00,3.00,False,False,False,True,40
Ryan,2024-08-16,Wells Fargo Autograph Visa ****5037,PICAZZOS HEALTHY ITALI TEMPE AZ,Picazzo's,114.86,114.86,,Dining & Drinks,7516.03,114.86,114.86,0.00,simple,False,,expense_history_csv,Consolidated_Expense_History_20250622.csv,2025-07-18T12:32:53.413399,3.0,advanced_calculations_v3,exp_v3_001307,2024.00,8.00,3.00,False,False,False,True,40
Ryan,2024-08-17,Wells Fargo Autograph Visa ****5037,PAR*MR. PICKLES SANDWICH CHANDLER AZ,Mr. Pickles Sandwich,37.88,37.88,,Dining & Drinks,7553.91,37.88,37.88,0.00,simple,False,,expense_history_csv,Consolidated_Expense_History_20250622.csv,2025-07-18T12:32:53.413399,3.0,advanced_calculations_v3,exp_v3_001308,2024.00,8.00,3.00,False,False,False,True,40
Ryan,2024-08-24,Wells Fargo Autograph Visa ****5037,LEBANESE PALACE LLC CHANDLER AZ,Lebanese Palace,63.38,63.38,,Dining & Drinks,7617.29,63.38,63.38,0.00,simple,False,,expense_history_csv,Consolidated_Expense_History_20250622.csv,2025-07-18T12:32:53.413399,3.0,advanced_calculations_v3,exp_v3_001309,2024.00,8.00,3.00,False,False,False,True,40
Ryan,2024-08-25,Wells Fargo Autograph Visa ****5037,CHEVRON 0209999 CHANDLER AZ,Chevron,34.81,34.81,,Auto & Transport,7652.10,34.81,34.81,0.00,simple,False,,expense_history_csv,Consolidated_Expense_History_20250622.csv,2025-07-18T12:32:53.413399,3.0,advanced_calculations_v3,exp_v3_001310,2024.00,8.00,3.00,False,False,False,True,40
Ryan,2024-08-25,Wells Fargo Autograph Visa ****5037,COOPERS HAWK CHANDLER CHANDLER AZ,Cooper's Hawk,117.93,117.93,,Groceries,7770.03,117.93,117.93,0.00,simple,False,,expense_history_csv,Consolidated_Expense_History_20250622.csv,2025-07-18T12:32:53.413399,3.0,advanced_calculations_v3,exp_v3_001311,2024.00,8.00,3.00,False,False,False,True,40
Ryan,2024-08-27,Wells Fargo Autograph Visa ****5037,Netflix 1 8445052993 CA,Netflix,24.78,24.78,,Entertainment & Rec.,7794.81,24.78,24.78,0.00,simple,False,,expense_history_csv,Consolidated_Expense_History_20250622.csv,2025-07-18T12:32:53.413399,3.0,advanced_calculations_v3,exp_v3_001312,2024.00,8.00,3.00,False,False,False,True,40
Ryan,2024-08-30,Wells Fargo Autograph Visa ****5037,IN-N-OUT CHANDLER 2 CHANDLER AZ,In-N-Out,18.65,18.65,,Dining & Drinks,7813.46,18.65,18.65,0.00,simple,False,,expense_history_csv,Consolidated_Expense_History_20250622.csv,2025-07-18T12:32:53.413399,3.0,advanced_calculations_v3,exp_v3_001313,2024.00,8.00,3.00,False,False,False,True,40
Ryan,2024-08-31,Wells Fargo Autograph Visa ****5037,CIRCLE K 09183 CHANDLER AZ,Circle K,21.13,21.13,,Shopping,7834.59,21.13,21.13,0.00,simple,False,,expense_history_csv,Consolidated_Expense_History_20250622.csv,2025-07-18T12:32:53.413399,3.0,advanced_calculations_v3,exp_v3_001314,2024.00,8.00,3.00,False,False,False,True,40
Ryan,2024-09-01,Wells Fargo Autograph Visa ****5037,ACE PARKING 1068 SAN DIEGO CA,Ace Parking,21.00,21.00,,Auto & Transport,7855.59,21.00,21.00,0.00,simple,False,,expense_history_csv,Consolidated_Expense_History_20250622.csv,2025-07-18T12:32:53.413399,3.0,advanced_calculations_v3,exp_v3_001315,2024.00,9.00,3.00,False,False,False,True,40
Ryan,2024-09-01,Wells Fargo Autograph Visa ****5037,CIRCLE K # 03479 GILA BEND AZ,Circle K,16.58,16.58,,Shopping,7872.17,16.58,16.58,0.00,simple,False,,expense_history_csv,Consolidated_Expense_History_20250622.csv,2025-07-18T12:32:53.413399,3.0,advanced_calculations_v3,exp_v3_001316,2024.00,9.00,3.00,False,False,False,True,40
Ryan,2024-09-01,Wells Fargo Autograph Visa ****5037,CIRCLE K # 03479 GILA BEND AZ,Circle K,25.23,25.23,,Shopping,7897.40,25.23,25.23,0.00,simple,False,,expense_history_csv,Consolidated_Expense_History_20250622.csv,2025-07-18T12:32:53.413399,3.0,advanced_calculations_v3,exp_v3_001317,2024.00,9.00,3.00,False,False,False,True,40
Ryan,2024-09-02,Wells Fargo Autograph Visa ****5037,7-ELEVEN 39518 EL CENTRO CA,7-Eleven,6.24,6.24,,Shopping,7903.64,6.24,6.24,0.00,simple,False,,expense_history_csv,Consolidated_Expense_History_20250622.csv,2025-07-18T12:32:53.413399,3.0,advanced_calculations_v3,exp_v3_001318,2024.00,9.00,3.00,False,False,False,True,40
Ryan,2024-09-02,Wells Fargo Autograph Visa ****5037,A TOUCH OF THAI YUMA AZ,A Touch of Thai,34.32,34.32,,Dining & Drinks,7937.96,34.32,34.32,0.00,simple,False,,expense_history_csv,Consolidated_Expense_History_20250622.csv,2025-07-18T12:32:53.413399,3.0,advanced_calculations_v3,exp_v3_001319,2024.00,9.00,3.00,False,False,False,True,40
Ryan,2024-09-02,Wells Fargo Autograph Visa ****5037,ACE PARKING 1068 SAN DIEGO CA,Ace Parking,17.00,17.00,,Auto & Transport,7954.96,17.00,17.00,0.00,simple,False,,expense_history_csv,Consolidated_Expense_History_20250622.csv,2025-07-18T12:32:53.413399,3.0,advanced_calculations_v3,exp_v3_001320,2024.00,9.00,3.00,False,False,False,True,40
Ryan,2024-09-02,Wells Fargo Autograph Visa ****5037,OMNI SAN DIEGO FRONT D 619-2316664 CA,Omni San Diego Hotel,324.58,324.58,,Travel & Vacation,8279.54,324.58,324.58,0.00,simple,False,,expense_history_csv,Consolidated_Expense_History_20250622.csv,2025-07-18T12:32:53.413399,3.0,advanced_calculations_v3,exp_v3_001321,2024.00,9.00,3.00,False,False,False,True,40
Ryan,2024-09-02,Wells Fargo Autograph Visa ****5037,OMNI SAN DIEGO FRONT D SAN DIEGO CA,Omni San Diego Hotel,338.12,338.12,,Travel & Vacation,8617.66,338.12,338.12,0.00,simple,False,,expense_history_csv,Consolidated_Expense_History_20250622.csv,2025-07-18T12:32:53.413399,3.0,advanced_calculations_v3,exp_v3_001322,2024.00,9.00,3.00,False,False,False,True,40
Ryan,2024-09-04,Wells Fargo Autograph Visa ****5037,AKCHIN PAVILION AMPHI PHOENIX AZ,Ak-Chin Pavilion,39.10,39.10,,Entertainment & Rec.,8656.76,39.10,39.10,0.00,simple,False,,expense_history_csv,Consolidated_Expense_History_20250622.csv,2025-07-18T12:32:53.413399,3.0,advanced_calculations_v3,exp_v3_001323,2024.00,9.00,3.00,False,False,False,True,40
Ryan,2024-09-04,Wells Fargo Autograph Visa ****5037,DOLLAR TREE CHANDLER AZ,Dollar Tree,37.65,37.65,,Shopping,8694.41,37.65,37.65,0.00,simple,False,,expense_history_csv,Consolidated_Expense_History_20250622.csv,2025-07-18T12:32:53.413399,3.0,advanced_calculations_v3,exp_v3_001324,2024.00,9.00,3.00,False,False,False,True,40
Ryan,2024-09-04,Wells Fargo Autograph Visa ****5037,PITA KITCHEN - AVONDALE AVONDALE AZ,Pita Kitchen,35.58,35.58,,Dining & Drinks,8729.99,35.58,35.58,0.00,simple,False,,expense_history_csv,Consolidated_Expense_History_20250622.csv,2025-07-18T12:32:53.413399,3.0,advanced_calculations_v3,exp_v3_001325,2024.00,9.00,3.00,False,False,False,True,40
Ryan,2024-09-05,Wells Fargo Autograph Visa ****5037,CHEVRON 0209999 CHANDLER AZ,Chevron,48.62,48.62,,Auto & Transport,8778.61,48.62,48.62,0.00,simple,False,,expense_history_csv,Consolidated_Expense_History_20250622.csv,2025-07-18T12:32:53.413399,3.0,advanced_calculations_v3,exp_v3_001326,2024.00,9.00,3.00,False,False,False,True,40
Ryan,2024-09-05,Wells Fargo Autograph Visa ****5037,CHEVRON 0209999 CHANDLER AZ,Chevron,9.26,9.26,,Auto & Transport,8787.87,9.26,9.26,0.00,simple,False,,expense_history_csv,Consolidated_Expense_History_20250622.csv,2025-07-18T12:32:53.413399,3.0,advanced_calculations_v3,exp_v3_001327,2024.00,9.00,3.00,False,False,False,True,40
Ryan,2024-09-07,Wells Fargo Autograph Visa ****5037,PICAZZOS HEALTHY ITALI TEMPE AZ,Picazzo's,30.05,30.05,,Dining & Drinks,8817.92,30.05,30.05,0.00,simple,False,,expense_history_csv,Consolidated_Expense_History_20250622.csv,2025-07-18T12:32:53.413399,3.0,advanced_calculations_v3,exp_v3_001328,2024.00,9.00,3.00,False,False,False,True,40
Ryan,2024-09-08,Wells Fargo Autograph Visa ****5037,BOOTLEGGERS SMOKEHOUSE SCOTTSDALE AZ,Bootleggers Smokehouse,109.76,109.76,,Dining & Drinks,8927.68,109.76,109.76,0.00,simple,False,,expense_history_csv,Consolidated_Expense_History_20250622.csv,2025-07-18T12:32:53.413399,3.0,advanced_calculations_v3,exp_v3_001329,2024.00,9.00,3.00,False,False,False,True,40
Ryan,2024-09-13,Wells Fargo Autograph Visa ****5037,CULVERS OF CHANDLER CHANDLER AZ,Culver's,11.55,11.55,,Dining & Drinks,8939.23,11.55,11.55,0.00,simple,False,,expense_history_csv,Consolidated_Expense_History_20250622.csv,2025-07-18T12:32:53.413399,3.0,advanced_calculations_v3,exp_v3_001330,2024.00,9.00,3.00,False,False,False,True,40
Ryan,2024-09-15,Wells Fargo Autograph Visa ****5037,MASTRO'S-OCEANCLUB(SD) SCOTTSDALE AZ,Mastro's Ocean Club,523.99,523.99,,Shopping,9463.22,523.99,523.99,0.00,simple,False,,expense_history_csv,Consolidated_Expense_History_20250622.csv,2025-07-18T12:32:53.413399,3.0,advanced_calculations_v3,exp_v3_001331,2024.00,9.00,3.00,False,False,False,True,40
Ryan,2024-09-20,Wells Fargo Autograph Visa ****5037,VCA Animal Hospitals HTTPSVCAHOSPICA,VCA Animal Hospitals,438.70,438.70,,Pets,9901.92,438.70,438.70,0.00,simple,False,,expense_history_csv,Consolidated_Expense_History_20250622.csv,2025-07-18T12:32:53.413399,3.0,advanced_calculations_v3,exp_v3_001332,2024.00,9.00,3.00,False,False,False,True,40
Ryan,2024-09-21,Wells Fargo Autograph Visa ****5037,TST*ISLAND FIN POKE - GI Gilbert AZ,Island Fin Poke,38.90,38.90,,Dining & Drinks,9940.82,38.90,38.90,0.00,simple,False,,expense_history_csv,Consolidated_Expense_History_20250622.csv,2025-07-18T12:32:53.413399,3.0,advanced_calculations_v3,exp_v3_001333,2024.00,9.00,3.00,False,False,False,True,40
Ryan,2024-09-21,Wells Fargo Autograph Visa ****5037,DANGERZONE ARCADE 602-4036470 AZ,Dangerzone Arcade,20.00,20.00,,Entertainment,9960.82,20.00,20.00,0.00,simple,False,,expense_history_csv,Consolidated_Expense_History_20250622.csv,2025-07-18T12:32:53.413399,3.0,advanced_calculations_v3,exp_v3_001334,2024.00,9.00,3.00,False,False,False,True,40
Ryan,2024-09-21,Wells Fargo Autograph Visa ****5037,SHELL OIL 10015892002 CHANDLER AZ,Shell,50.90,50.90,,Auto & Transport,10011.72,50.90,50.90,0.00,simple,False,,expense_history_csv,Consolidated_Expense_History_20250622.csv,2025-07-18T12:32:53.413399,3.0,advanced_calculations_v3,exp_v3_001335,2024.00,9.00,3.00,False,False,False,True,40
Ryan,2024-09-22,Wells Fargo Autograph Visa ****5037,PAR*MR. PICKLES SANDWICH CHANDLER AZ,Mr. Pickles Sandwich,51.56,51.56,,Dining & Drinks,10063.28,51.56,51.56,0.00,simple,False,,expense_history_csv,Consolidated_Expense_History_20250622.csv,2025-07-18T12:32:53.413399,3.0,advanced_calculations_v3,exp_v3_001336,2024.00,9.00,3.00,False,False,False,True,40
Ryan,2024-09-22,Wells Fargo Autograph Visa ****5037,TST*UNCLE BEAR'S BREWERYGILBET AZ,Uncle Bear's Brewery,33.57,33.57,,Dining & Drinks,10096.85,33.57,33.57,0.00,simple,False,,expense_history_csv,Consolidated_Expense_History_20250622.csv,2025-07-18T12:32:53.413399,3.0,advanced_calculations_v3,exp_v3_001337,2024.00,9.00,3.00,False,False,False,True,40
Ryan,2024-07-01,Wells Fargo Checking ****3850,PARKMOBILE,ParkMobile,6.00,6.00,,Auto & Transport,10102.85,6.00,6.00,0.00,simple,False,,expense_history_csv,Consolidated_Expense_History_20250622.csv,2025-07-18T12:32:53.413399,3.0,advanced_calculations_v3,exp_v3_001338,2024.00,7.00,3.00,False,False,False,True,40
Ryan,2024-07-08,Wells Fargo Checking ****3850,COX COMM PHX,Cox Communications,120.00,120.00,,Bills & Utilities,10222.85,120.00,120.00,0.00,simple,False,,expense_history_csv,Consolidated_Expense_History_20250622.csv,2025-07-18T12:32:53.413399,3.0,advanced_calculations_v3,exp_v3_001339,2024.00,7.00,3.00,False,False,False,True,40
Ryan,2024-07-09,Wells Fargo Checking ****3850,AFFIRM * PAY,Affirm,10.61,10.61,,Loan Payment,10233.46,10.61,10.61,0.00,simple,False,,expense_history_csv,Consolidated_Expense_History_20250622.csv,2025-07-18T12:32:53.413399,3.0,advanced_calculations_v3,exp_v3_001340,2024.00,7.00,3.00,False,False,False,True,40
Ryan,2024-07-09,Wells Fargo Checking ****3850,AFFIRM * PAY,Affirm,31.25,31.25,,Loan Payment,10264.71,31.25,31.25,0.00,simple,False,,expense_history_csv,Consolidated_Expense_History_20250622.csv,2025-07-18T12:32:53.413399,3.0,advanced_calculations_v3,exp_v3_001341,2024.00,7.00,3.00,False,False,False,True,40
Ryan,2024-07-23,Wells Fargo Checking ****3850,BEST BUY,Best Buy,146.00,146.00,,Credit Card Payment,10410.71,146.00,146.00,0.00,simple,False,,expense_history_csv,Consolidated_Expense_History_20250622.csv,2025-07-18T12:32:53.413399,3.0,advanced_calculations_v3,exp_v3_001342,2024.00,7.00,3.00,False,False,False,True,40
Ryan,2024-07-26,Wells Fargo Checking ****3850,ATM WITHDRAWAL,ATM Withdrawal,200.00,200.00,,Cash & Checks,10610.71,200.00,200.00,0.00,simple,False,,expense_history_csv,Consolidated_Expense_History_20250622.csv,2025-07-18T12:32:53.413399,3.0,advanced_calculations_v3,exp_v3_001343,2024.00,7.00,3.00,False,False,False,True,40
Ryan,2024-07-26,Wells Fargo Checking ****3850,NON-WELLS FARGO ATM FEE,Non-Wells Fargo ATM Fee,2.50,2.50,,Fees,10613.21,2.50,2.50,0.00,simple,False,,expense_history_csv,Consolidated_Expense_History_20250622.csv,2025-07-18T12:32:53.413399,3.0,advanced_calculations_v3,exp_v3_001344,2024.00,7.00,3.00,False,False,False,True,40
Ryan,2024-07-26,Wells Fargo Checking ****3850,NON-WF ATM BALANCE INQUIRY FEE,Non-Wells Fargo ATM Inquiry Fee,2.50,2.50,,Fees,10615.71,2.50,2.50,0.00,simple,False,,expense_history_csv,Consolidated_Expense_History_20250622.csv,2025-07-18T12:32:53.413399,3.0,advanced_calculations_v3,exp_v3_001345,2024.00,7.00,3.00,False,False,False,True,40
Ryan,2024-07-26,Wells Fargo Checking ****3850,NON-WF ATM WITHDRAWAL,Non-Wells Fargo ATM Withdrawal,102.50,102.50,,Cash & Checks,10718.21,102.50,102.50,0.00,simple,False,,expense_history_csv,Consolidated_Expense_History_20250622.csv,2025-07-18T12:32:53.413399,3.0,advanced_calculations_v3,exp_v3_001346,2024.00,7.00,3.00,False,False,False,True,40
Ryan,2024-07-29,Wells Fargo Checking ****3850,AFFIRM * PAY,Affirm,21.12,21.12,,Loan Payment,10739.33,21.12,21.12,0.00,simple,False,,expense_history_csv,Consolidated_Expense_History_20250622.csv,2025-07-18T12:32:53.413399,3.0,advanced_calculations_v3,exp_v3_001347,2024.00,7.00,3.00,False,False,False,True,40
Ryan,2024-08-05,Wells Fargo Checking ****3850,COX COMM PHX,Cox Communications,120.00,120.00,,Bills & Utilities,10859.33,120.00,120.00,0.00,simple,False,,expense_history_csv,Consolidated_Expense_History_20250622.csv,2025-07-18T12:32:53.413399,3.0,advanced_calculations_v3,exp_v3_001348,2024.00,8.00,3.00,False,False,False,True,40
Ryan,2024-08-09,Wells Fargo Checking ****3850,AFFIRM.COM PAYMENT,Affirm,31.25,31.25,,Loan Payment,10890.58,31.25,31.25,0.00,simple,False,,expense_history_csv,Consolidated_Expense_History_20250622.csv,2025-07-18T12:32:53.413399,3.0,advanced_calculations_v3,exp_v3_001349,2024.00,8.00,3.00,False,False,False,True,40
Ryan,2024-08-09,Wells Fargo Checking ****3850,AFFIRM.COM PAYMENT,Affirm,10.61,10.61,,Loan Payment,10901.19,10.61,10.61,0.00,simple,False,,expense_history_csv,Consolidated_Expense_History_20250622.csv,2025-07-18T12:32:53.413399,3.0,advanced_calculations_v3,exp_v3_001350,2024.00,8.00,3.00,False,False,False,True,40
Ryan,2024-08-12,Wells Fargo Checking ****3850,AFFIRM * PAY,Affirm,224.77,224.77,,Loan Payment,11125.96,224.77,224.77,0.00,simple,False,,expense_history_csv,Consolidated_Expense_History_20250622.csv,2025-07-18T12:32:53.413399,3.0,advanced_calculations_v3,exp_v3_001351,2024.00,8.00,3.00,False,False,False,True,40
Ryan,2024-08-21,Wells Fargo Checking ****3850,MERCURY FBT PAYMENT,Mercury Bank,1281.30,1281.30,,Bills & Utilities,12407.26,1281.30,1281.30,0.00,simple,False,,expense_history_csv,Consolidated_Expense_History_20250622.csv,2025-07-18T12:32:53.413399,3.0,advanced_calculations_v3,exp_v3_001352,2024.00,8.00,3.00,False,False,False,True,40
Ryan,2024-08-23,Wells Fargo Checking ****3850,BEST BUY,Best Buy,146.00,146.00,,Credit Card Payment,12553.26,146.00,146.00,0.00,simple,False,,expense_history_csv,Consolidated_Expense_History_20250622.csv,2025-07-18T12:32:53.413399,3.0,advanced_calculations_v3,exp_v3_001353,2024.00,8.00,3.00,False,False,False,True,40
Ryan,2024-08-28,Wells Fargo Checking ****3850,AFFIRM * PAY,Affirm,21.12,21.12,,Loan Payment,12574.38,21.12,21.12,0.00,simple,False,,expense_history_csv,Consolidated_Expense_History_20250622.csv,2025-07-18T12:32:53.413399,3.0,advanced_calculations_v3,exp_v3_001354,2024.00,8.00,3.00,False,False,False,True,40
Ryan,2024-09-05,Wells Fargo Checking ****3850,COX COMM PHX,Cox Communications,120.00,120.00,,Bills & Utilities,12694.38,120.00,120.00,0.00,simple,False,,expense_history_csv,Consolidated_Expense_History_20250622.csv,2025-07-18T12:32:53.413399,3.0,advanced_calculations_v3,exp_v3_001355,2024.00,9.00,3.00,False,False,False,True,40
Ryan,2024-09-09,Wells Fargo Checking ****3850,AFFIRM * PAY,Affirm,31.25,31.25,,Loan Payment,12725.63,31.25,31.25,0.00,simple,False,,expense_history_csv,Consolidated_Expense_History_20250622.csv,2025-07-18T12:32:53.413399,3.0,advanced_calculations_v3,exp_v3_001356,2024.00,9.00,3.00,False,False,False,True,40
Ryan,2024-09-09,Wells Fargo Checking ****3850,AFFIRM * PAY,Affirm,10.61,10.61,,Loan Payment,12736.24,10.61,10.61,0.00,simple,False,,expense_history_csv,Consolidated_Expense_History_20250622.csv,2025-07-18T12:32:53.413399,3.0,advanced_calculations_v3,exp_v3_001357,2024.00,9.00,3.00,False,False,False,True,40
Ryan,2024-09-11,Wells Fargo Checking ****3850,AFFIRM * PAY,Affirm,224.77,224.77,,Loan Payment,12961.01,224.77,224.77,0.00,simple,False,,expense_history_csv,Consolidated_Expense_History_20250622.csv,2025-07-18T12:32:53.413399,3.0,advanced_calculations_v3,exp_v3_001358,2024.00,9.00,3.00,False,False,False,True,40
Ryan,2024-09-23,Wells Fargo Checking ****3851,Best Buy,Best Buy,146.00,146.00,,Credit Card Payment,13107.01,146.00,146.00,0.00,simple,False,,expense_history_csv,Consolidated_Expense_History_20250622.csv,2025-07-18T12:32:53.413399,3.0,advanced_calculations_v3,exp_v3_001359,2024.00,9.00,3.00,False,False,False,True,40
Ryan,2024-09-23,Wells Fargo Checking ****3852,BUSINESS TO BUSINESS ACH Rocket Money Premium ST-H6J2L8N9U4R3 ROCKET MONEY INC,Rocket Money,6.52,6.52,,Software & Tech,13113.53,6.52,6.52,0.00,simple,False,,expense_history_csv,Consolidated_Expense_History_20250622.csv,2025-07-18T12:32:53.413399,3.0,advanced_calculations_v3,exp_v3_001360,2024.00,9.00,3.00,False,False,False,True,40
Ryan,2024-09-27,Wells Fargo Checking ****3853,PURCHASE AFFIRM * PAY 855-423-3729 CA CARD0968,Affirm Payment,21.12,21.12,,Loan Payment,13134.65,21.12,21.12,0.00,simple,False,,expense_history_csv,Consolidated_Expense_History_20250622.csv,2025-07-18T12:32:53.413399,3.0,advanced_calculations_v3,exp_v3_001361,2024.00,9.00,3.00,False,False,False,True,40
Ryan,2024-09-30,Wells Fargo Checking ****3854,PURCHASE FBT CREDIT C WILMINGTON DE CARD0968,FBT Credit,300.00,300.00,,Uncategorized,13434.65,300.00,300.00,0.00,simple,False,,expense_history_csv,Consolidated_Expense_History_20250622.csv,2025-07-18T12:32:53.413399,3.0,advanced_calculations_v3,exp_v3_001362,2024.00,9.00,3.00,False,False,False,True,40
Ryan,2024-09-30,Wells Fargo Checking ****3855,PURCHASE FBT CREDIT C WILMINGTON DE CARD0968,FBT Credit,300.00,300.00,,Uncategorized,13734.65,300.00,300.00,0.00,simple,False,,expense_history_csv,Consolidated_Expense_History_20250622.csv,2025-07-18T12:32:53.413399,3.0,advanced_calculations_v3,exp_v3_001363,2024.00,9.00,3.00,False,False,False,True,40
Ryan,2024-07-04,Apple Pay (via SMS or Apple Touch Pay),Rebecca,Payment to Rebecca,220.00,220.00,,,13954.65,220.00,220.00,0.00,simple,False,,expense_history_csv,Consolidated_Expense_History_20250622.csv,2025-07-18T12:32:53.413399,3.0,advanced_calculations_v3,exp_v3_001364,2024.00,7.00,3.00,False,False,False,True,40
Ryan,2024-07-12,Apple Pay (via SMS or Apple Touch Pay),Rebecca,Payment to Rebecca,220.00,220.00,,,14174.65,220.00,220.00,0.00,simple,False,,expense_history_csv,Consolidated_Expense_History_20250622.csv,2025-07-18T12:32:53.413399,3.0,advanced_calculations_v3,exp_v3_001365,2024.00,7.00,3.00,False,False,False,True,40
Ryan,2024-07-21,Apple Pay (via SMS or Apple Touch Pay),Rebecca,Payment to Rebecca,220.00,220.00,,,14394.65,220.00,220.00,0.00,simple,False,,expense_history_csv,Consolidated_Expense_History_20250622.csv,2025-07-18T12:32:53.413399,3.0,advanced_calculations_v3,exp_v3_001366,2024.00,7.00,3.00,False,False,False,True,40
Ryan,2024-07-31,Apple Pay (via SMS or Apple Touch Pay),Rebecca,Payment to Rebecca,220.00,220.00,,,14614.65,220.00,220.00,0.00,simple,False,,expense_history_csv,Consolidated_Expense_History_20250622.csv,2025-07-18T12:32:53.413399,3.0,advanced_calculations_v3,exp_v3_001367,2024.00,7.00,3.00,False,False,False,True,40
Ryan,2024-08-04,Apple Pay (via SMS or Apple Touch Pay),Rebecca,Payment to Rebecca,240.00,240.00,,,14854.65,240.00,240.00,0.00,simple,False,,expense_history_csv,Consolidated_Expense_History_20250622.csv,2025-07-18T12:32:53.413399,3.0,advanced_calculations_v3,exp_v3_001368,2024.00,8.00,3.00,False,False,False,True,40
Ryan,2024-08-16,Apple Pay (via SMS or Apple Touch Pay),Rebecca,Payment to Rebecca,220.00,220.00,,,15074.65,220.00,220.00,0.00,simple,False,,expense_history_csv,Consolidated_Expense_History_20250622.csv,2025-07-18T12:32:53.413399,3.0,advanced_calculations_v3,exp_v3_001369,2024.00,8.00,3.00,False,False,False,True,40
Ryan,2024-08-26,Apple Pay (via SMS or Apple Touch Pay),Rebecca,Payment to Rebecca,460.00,460.00,,,15534.65,460.00,460.00,0.00,simple,False,,expense_history_csv,Consolidated_Expense_History_20250622.csv,2025-07-18T12:32:53.413399,3.0,advanced_calculations_v3,exp_v3_001370,2024.00,8.00,3.00,False,False,False,True,40
Ryan,2024-09-08,Apple Pay (via SMS or Apple Touch Pay),Rebecca,Payment to Rebecca,260.00,260.00,,,15794.65,260.00,260.00,0.00,simple,False,,expense_history_csv,Consolidated_Expense_History_20250622.csv,2025-07-18T12:32:53.413399,3.0,advanced_calculations_v3,exp_v3_001371,2024.00,9.00,3.00,False,False,False,True,40
Ryan,2024-09-14,Apple Pay (via SMS or Apple Touch Pay),Rebecca,Payment to Rebecca,500.00,500.00,,,16294.65,500.00,500.00,0.00,simple,False,,expense_history_csv,Consolidated_Expense_History_20250622.csv,2025-07-18T12:32:53.413399,3.0,advanced_calculations_v3,exp_v3_001372,2024.00,9.00,3.00,False,False,False,True,40
Ryan,2024-09-25,Apple Pay (via SMS or Apple Touch Pay),Rebecca,Payment to Rebecca,500.00,500.00,,,16794.65,500.00,500.00,0.00,simple,False,,expense_history_csv,Consolidated_Expense_History_20250622.csv,2025-07-18T12:32:53.413399,3.0,advanced_calculations_v3,exp_v3_001373,2024.00,9.00,3.00,False,False,False,True,40
Ryan,2024-07-14,Apple Pay (via SMS or Apple Touch Pay),Jordan,Payment to Jordan,225.00,225.00,,,17019.65,225.00,225.00,0.00,simple,False,,expense_history_csv,Consolidated_Expense_History_20250622.csv,2025-07-18T12:32:53.413399,3.0,advanced_calculations_v3,exp_v3_001374,2024.00,7.00,3.00,False,False,False,True,40
Ryan,2024-07-31,Apple Pay (via SMS or Apple Touch Pay),Jordan,Payment to Jordan,450.00,450.00,,,17469.65,450.00,450.00,0.00,simple,False,,expense_history_csv,Consolidated_Expense_History_20250622.csv,2025-07-18T12:32:53.413399,3.0,advanced_calculations_v3,exp_v3_001375,2024.00,7.00,3.00,False,False,False,True,40
Ryan,2024-08-17,Apple Pay (via SMS or Apple Touch Pay),Jordan,Payment to Jordan,300.00,300.00,,,17769.65,300.00,300.00,0.00,simple,False,,expense_history_csv,Consolidated_Expense_History_20250622.csv,2025-07-18T12:32:53.413399,3.0,advanced_calculations_v3,exp_v3_001376,2024.00,8.00,3.00,False,False,False,True,40
Ryan,2024-08-30,Apple Pay (via SMS or Apple Touch Pay),Jordan,Payment to Jordan,225.00,225.00,,,17994.65,225.00,225.00,0.00,simple,False,,expense_history_csv,Consolidated_Expense_History_20250622.csv,2025-07-18T12:32:53.413399,3.0,advanced_calculations_v3,exp_v3_001377,2024.00,8.00,3.00,False,False,False,True,40
Ryan,2024-09-07,Apple Pay (via SMS or Apple Touch Pay),Jordan,Payment to Jordan,260.00,260.00,,,18254.65,260.00,260.00,0.00,simple,False,,expense_history_csv,Consolidated_Expense_History_20250622.csv,2025-07-18T12:32:53.413399,3.0,advanced_calculations_v3,exp_v3_001378,2024.00,9.00,3.00,False,False,False,True,40
Ryan,2024-09-20,Apple Pay (via SMS or Apple Touch Pay),Jordan,Payment to Jordan,450.00,450.00,,,18704.65,450.00,450.00,0.00,simple,False,,expense_history_csv,Consolidated_Expense_History_20250622.csv,2025-07-18T12:32:53.413399,3.0,advanced_calculations_v3,exp_v3_001379,2024.00,9.00,3.00,False,False,False,True,40
Jordyn Expenses,,,,,,,,,,,,0.00,simple,False,,expense_history_csv,Consolidated_Expense_History_20250622.csv,2025-07-18T12:32:53.413399,3.0,advanced_calculations_v3,exp_v3_001380,,,,False,False,False,False,-20
Name,,Account,Merchant,Merchant Description,,,Description,Category,,,,0.00,simple,False,,expense_history_csv,Consolidated_Expense_History_20250622.csv,2025-07-18T12:32:53.413399,3.0,advanced_calculations_v3,exp_v3_001381,,,,False,False,False,False,0
Jordyn,2024-07-04,Wells Fargo Active Cash Visa Signature,FRYS-FOOD-DRG #051 CHANDLER AZ,Fry's Food and Drug,102.89,102.89,,Groceries,102.89,102.89,102.89,0.00,simple,False,,expense_history_csv,Consolidated_Expense_History_20250622.csv,2025-07-18T12:32:53.413399,3.0,advanced_calculations_v3,exp_v3_001382,2024.00,7.00,3.00,False,False,False,True,40
Jordyn,2024-07-06,Wells Fargo Active Cash Visa Signature,TOTAL WINE AND MORE PHOENIX AZ,Total Wine & More,80.62,80.62,,Alcohol,183.51,80.62,80.62,0.00,simple,False,,expense_history_csv,Consolidated_Expense_History_20250622.csv,2025-07-18T12:32:53.413399,3.0,advanced_calculations_v3,exp_v3_001383,2024.00,7.00,3.00,False,False,False,True,40
Jordyn,2024-07-06,Wells Fargo Active Cash Visa Signature,AMAZON.COM*R71IE4QJ2 SEATTLE WA,Amazon.com,30.17,30.17,,Online Shopping,213.68,30.17,30.17,0.00,simple,False,,expense_history_csv,Consolidated_Expense_History_20250622.csv,2025-07-18T12:32:53.413399,3.0,advanced_calculations_v3,exp_v3_001384,2024.00,7.00,3.00,False,False,False,True,40
Jordyn,2024-07-07,Wells Fargo Active Cash Visa Signature,IN-N-OUT PRESCOTT PRESCOTT AZ,In-N-Out,11.59,11.59,,Dining,225.27,11.59,11.59,0.00,simple,False,,expense_history_csv,Consolidated_Expense_History_20250622.csv,2025-07-18T12:32:53.413399,3.0,advanced_calculations_v3,exp_v3_001385,2024.00,7.00,3.00,False,False,False,True,40
Jordyn,2024-07-08,Wells Fargo Active Cash Visa Signature,AMTRAK MOBIL1900710219973 WASHINGTON DC,Amtrak,54.00,54.00,,Transportation,279.27,54.00,54.00,0.00,simple,False,,expense_history_csv,Consolidated_Expense_History_20250622.csv,2025-07-18T12:32:53.413399,3.0,advanced_calculations_v3,exp_v3_001386,2024.00,7.00,3.00,False,False,False,True,40
Jordyn,2024-07-09,Wells Fargo Active Cash Visa Signature,TARGET 00018382 CHANDLER AZ,Target,66.03,66.03,,Shopping,345.30,66.03,66.03,0.00,simple,False,,expense_history_csv,Consolidated_Expense_History_20250622.csv,2025-07-18T12:32:53.413399,3.0,advanced_calculations_v3,exp_v3_001387,2024.00,7.00,3.00,False,False,False,True,40
Jordyn,2024-07-09,Wells Fargo Active Cash Visa Signature,FRYS 5051 866-576-4377 AZ,Fry's,244.38,244.38,,Groceries,589.68,244.38,244.38,0.00,simple,False,,expense_history_csv,Consolidated_Expense_History_20250622.csv,2025-07-18T12:32:53.413399,3.0,advanced_calculations_v3,exp_v3_001388,2024.00,7.00,3.00,False,False,False,True,40
Jordyn,2024-07-14,Wells Fargo Active Cash Visa Signature,TST* O.H.S.O. - GILBERT GILBERT AZ,O.H.S.O. Restaurant,118.85,118.85,,Dining,708.53,118.85,118.85,0.00,simple,False,,expense_history_csv,Consolidated_Expense_History_20250622.csv,2025-07-18T12:32:53.413399,3.0,advanced_calculations_v3,exp_v3_001389,2024.00,7.00,3.00,False,False,False,True,40
Jordyn,2024-07-14,Wells Fargo Active Cash Visa Signature,AMAZON MKTPL*RY2RM8762 Amzn.com/bill WA,Amazon Marketplace,17.14,17.14,,Online Shopping,725.67,17.14,17.14,0.00,simple,False,,expense_history_csv,Consolidated_Expense_History_20250622.csv,2025-07-18T12:32:53.413399,3.0,advanced_calculations_v3,exp_v3_001390,2024.00,7.00,3.00,False,False,False,True,40
Jordyn,2024-07-14,Wells Fargo Active Cash Visa Signature,UNPHOGETTABLE CHANDLER CHANDLER AZ,Unphogettable Restaurant,46.78,46.78,,Dining,772.45,46.78,46.78,0.00,simple,False,,expense_history_csv,Consolidated_Expense_History_20250622.csv,2025-07-18T12:32:53.413399,3.0,advanced_calculations_v3,exp_v3_001391,2024.00,7.00,3.00,False,False,False,True,40
Jordyn,2024-07-15,Wells Fargo Active Cash Visa Signature,MY PET MARKET #15 480-8214500 AZ,My Pet Market,131.50,131.50,,Pets,903.95,131.50,131.50,0.00,simple,False,,expense_history_csv,Consolidated_Expense_History_20250622.csv,2025-07-18T12:32:53.413399,3.0,advanced_calculations_v3,exp_v3_001392,2024.00,7.00,3.00,False,False,False,True,40
Jordyn,2024-07-16,Wells Fargo Active Cash Visa Signature,SPROUTS FARMERS MAR CHANDLER AZ,Sprouts Farmers Market,47.19,47.19,,Groceries,951.14,47.19,47.19,0.00,simple,False,,expense_history_csv,Consolidated_Expense_History_20250622.csv,2025-07-18T12:32:53.413399,3.0,advanced_calculations_v3,exp_v3_001393,2024.00,7.00,3.00,False,False,False,True,40
Jordyn,2024-07-16,Wells Fargo Active Cash Visa Signature,AMAZON MKTPL*RS14F6ZM2 Amzn.com/bill WA,Amazon Marketplace,31.64,31.64,,Online Shopping,982.78,31.64,31.64,0.00,simple,False,,expense_history_csv,Consolidated_Expense_History_20250622.csv,2025-07-18T12:32:53.413399,3.0,advanced_calculations_v3,exp_v3_001394,2024.00,7.00,3.00,False,False,False,True,40
Jordyn,2024-07-18,Wells Fargo Active Cash Visa Signature,AMAZON MKTPL*RS9DW6DT2 Amzn.com/bill WA,Amazon Marketplace,102.22,102.22,,Online Shopping,1085.00,102.22,102.22,0.00,simple,False,,expense_history_csv,Consolidated_Expense_History_20250622.csv,2025-07-18T12:32:53.413399,3.0,advanced_calculations_v3,exp_v3_001395,2024.00,7.00,3.00,False,False,False,True,40
Jordyn,2024-07-19,Wells Fargo Active Cash Visa Signature,PICAZZOS HEALTHY ITALI TEMPE AZ,Picazzo's Healthy Italian,50.16,50.16,,Dining,1135.16,50.16,50.16,0.00,simple,False,,expense_history_csv,Consolidated_Expense_History_20250622.csv,2025-07-18T12:32:53.413399,3.0,advanced_calculations_v3,exp_v3_001396,2024.00,7.00,3.00,False,False,False,True,40
Jordyn,2024-07-21,Wells Fargo Active Cash Visa Signature,MANUEL'S #7 TEMPE AZ,Manuel's Restaurant,78.00,78.00,,Dining,1213.16,78.00,78.00,0.00,simple,False,,expense_history_csv,Consolidated_Expense_History_20250622.csv,2025-07-18T12:32:53.413399,3.0,advanced_calculations_v3,exp_v3_001397,2024.00,7.00,3.00,False,False,False,True,40
Jordyn,2024-07-23,Wells Fargo Active Cash Visa Signature,TARGET 00018382 CHANDLER AZ,Target,10.19,10.19,,Shopping,1223.35,10.19,10.19,0.00,simple,False,,expense_history_csv,Consolidated_Expense_History_20250622.csv,2025-07-18T12:32:53.413399,3.0,advanced_calculations_v3,exp_v3_001398,2024.00,7.00,3.00,False,False,False,True,40
Jordyn,2024-07-23,Wells Fargo Active Cash Visa Signature,TARGET 00018382 CHANDLER AZ,Target,137.12,137.12,,Shopping,1360.47,137.12,137.12,0.00,simple,False,,expense_history_csv,Consolidated_Expense_History_20250622.csv,2025-07-18T12:32:53.413399,3.0,advanced_calculations_v3,exp_v3_001399,2024.00,7.00,3.00,False,False,False,True,40
Jordyn,2024-07-23,Wells Fargo Active Cash Visa Signature,AMAZON MKTPL*RJ9FA2KA0 Amzn.com/bill WA,Amazon Marketplace,26.56,26.56,,Online Shopping,1387.03,26.56,26.56,0.00,simple,False,,expense_history_csv,Consolidated_Expense_History_20250622.csv,2025-07-18T12:32:53.413399,3.0,advanced_calculations_v3,exp_v3_001400,2024.00,7.00,3.00,False,False,False,True,40
Jordyn,2024-07-23,Wells Fargo Active Cash Visa Signature,AMAZON MKTPLACE PMTS Amzn.com/bill WA,Amazon Marketplace (Refund),-9.23,-9.23,,Refund,1377.80,-9.23,-9.23,0.00,simple,False,,expense_history_csv,Consolidated_Expense_History_20250622.csv,2025-07-18T12:32:53.413399,3.0,advanced_calculations_v3,exp_v3_001401,2024.00,7.00,3.00,False,False,False,True,40
Jordyn,2024-07-25,Wells Fargo Active Cash Visa Signature,TST* SIP WINE BAR PHOENIX AZ,Sip Wine Bar,33.47,33.47,,Dining,1411.27,33.47,33.47,0.00,simple,False,,expense_history_csv,Consolidated_Expense_History_20250622.csv,2025-07-18T12:32:53.413399,3.0,advanced_calculations_v3,exp_v3_001402,2024.00,7.00,3.00,False,False,False,True,40
Jordyn,2024-07-25,Wells Fargo Active Cash Visa Signature,SOUTHWESTAIR INFLIGHT DALLAS TX,Southwest Airlines,52.00,52.00,,Travel,1463.27,52.00,52.00,0.00,simple,False,,expense_history_csv,Consolidated_Expense_History_20250622.csv,2025-07-18T12:32:53.413399,3.0,advanced_calculations_v3,exp_v3_001403,2024.00,7.00,3.00,False,False,False,True,40
Jordyn,2024-07-25,Wells Fargo Active Cash Visa Signature,PEDAL HAUS BREWERY PHOENIX AZ,Pedal Haus Brewery,38.76,38.76,,Dining,1502.03,38.76,38.76,0.00,simple,False,,expense_history_csv,Consolidated_Expense_History_20250622.csv,2025-07-18T12:32:53.413399,3.0,advanced_calculations_v3,exp_v3_001404,2024.00,7.00,3.00,False,False,False,True,40
Jordyn,2024-07-26,Wells Fargo Active Cash Visa Signature,EVOLVE BY HUDSON ST236 DES PLAINES IL,Evolve by Hudson,8.51,8.51,,Travel,1510.54,8.51,8.51,0.00,simple,False,,expense_history_csv,Consolidated_Expense_History_20250622.csv,2025-07-18T12:32:53.413399,3.0,advanced_calculations_v3,exp_v3_001405,2024.00,7.00,3.00,False,False,False,True,40
Jordyn,2024-07-26,Wells Fargo Active Cash Visa Signature,WALGREENS #12304 CHICAGO IL,Walgreens,4.09,4.09,,Shopping,1514.63,4.09,4.09,0.00,simple,False,,expense_history_csv,Consolidated_Expense_History_20250622.csv,2025-07-18T12:32:53.413399,3.0,advanced_calculations_v3,exp_v3_001406,2024.00,7.00,3.00,False,False,False,True,40
Jordyn,2024-07-26,Wells Fargo Active Cash Visa Signature,UBER TRIP HELP.UBER.COM CA,Uber Ride Service,36.90,36.90,,Transportation,1551.53,36.90,36.90,0.00,simple,False,,expense_history_csv,Consolidated_Expense_History_20250622.csv,2025-07-18T12:32:53.413399,3.0,advanced_calculations_v3,exp_v3_001407,2024.00,7.00,3.00,False,False,False,True,40
Jordyn,2024-07-26,Wells Fargo Active Cash Visa Signature,ACCENTS PLUS EVANSTON IL,Accents Plus,30.32,30.32,,Shopping,1581.85,30.32,30.32,0.00,simple,False,,expense_history_csv,Consolidated_Expense_History_20250622.csv,2025-07-18T12:32:53.413399,3.0,advanced_calculations_v3,exp_v3_001408,2024.00,7.00,3.00,False,False,False,True,40
Jordyn,2024-07-26,Wells Fargo Active Cash Visa Signature,TST* ONESTO Milwaukee WI,Onesto Restaurant,136.99,136.99,,Dining,1718.84,136.99,136.99,0.00,simple,False,,expense_history_csv,Consolidated_Expense_History_20250622.csv,2025-07-18T12:32:53.413399,3.0,advanced_calculations_v3,exp_v3_001409,2024.00,7.00,3.00,False,False,False,True,40
Jordyn,2024-07-26,Wells Fargo Active Cash Visa Signature,HILTON HOTELS RESTAURANT MILWAUKEE WI,Hilton Hotels,44.02,44.02,,Travel,1762.86,44.02,44.02,0.00,simple,False,,expense_history_csv,Consolidated_Expense_History_20250622.csv,2025-07-18T12:32:53.413399,3.0,advanced_calculations_v3,exp_v3_001410,2024.00,7.00,3.00,False,False,False,True,40
Jordyn,2024-07-27,Wells Fargo Active Cash Visa Signature,SWEET DREAMS HARTLAND WI,Sweet Dreams,5.78,5.78,,Shopping,1768.64,5.78,5.78,0.00,simple,False,,expense_history_csv,Consolidated_Expense_History_20250622.csv,2025-07-18T12:32:53.413399,3.0,advanced_calculations_v3,exp_v3_001411,2024.00,7.00,3.00,False,False,False,True,40
Jordyn,2024-07-27,Wells Fargo Active Cash Visa Signature,WALGREENS #9365 HARTLAND WI,Walgreens,2.30,2.30,,Shopping,1770.94,2.30,2.30,0.00,simple,False,,expense_history_csv,Consolidated_Expense_History_20250622.csv,2025-07-18T12:32:53.413399,3.0,advanced_calculations_v3,exp_v3_001412,2024.00,7.00,3.00,False,False,False,True,40
Jordyn,2024-07-27,Wells Fargo Active Cash Visa Signature,TST* ANYTIME AREPA - 140 Milwaukee WI,Anytime Arepa,15.17,15.17,,Dining,1786.11,15.17,15.17,0.00,simple,False,,expense_history_csv,Consolidated_Expense_History_20250622.csv,2025-07-18T12:32:53.413399,3.0,advanced_calculations_v3,exp_v3_001413,2024.00,7.00,3.00,False,False,False,True,40
Jordyn,2024-07-27,Wells Fargo Active Cash Visa Signature,TST* 3RD STREET MARKET HA Milwaukee WI,3rd Street Market,12.84,12.84,,Shopping,1798.95,12.84,12.84,0.00,simple,False,,expense_history_csv,Consolidated_Expense_History_20250622.csv,2025-07-18T12:32:53.413399,3.0,advanced_calculations_v3,exp_v3_001414,2024.00,7.00,3.00,False,False,False,True,40
Jordyn,2024-07-28,Wells Fargo Active Cash Visa Signature,EXXON W-P-P MOBIL MILWAUKEE WI,Exxon,5.58,5.58,,Transportation,1804.53,5.58,5.58,0.00,simple,False,,expense_history_csv,Consolidated_Expense_History_20250622.csv,2025-07-18T12:32:53.413399,3.0,advanced_calculations_v3,exp_v3_001415,2024.00,7.00,3.00,False,False,False,True,40
Jordyn,2024-07-28,Wells Fargo Active Cash Visa Signature,PICK N SAVE #882 MILWAUKEE WI,Pick N Save,8.07,8.07,,Groceries,1812.60,8.07,8.07,0.00,simple,False,,expense_history_csv,Consolidated_Expense_History_20250622.csv,2025-07-18T12:32:53.413399,3.0,advanced_calculations_v3,exp_v3_001416,2024.00,7.00,3.00,False,False,False,True,40
Jordyn,2024-07-28,Wells Fargo Active Cash Visa Signature,UBER TRIP HELP.UBER.COM CA,Uber Ride Service,51.97,51.97,,Transportation,1864.57,51.97,51.97,0.00,simple,False,,expense_history_csv,Consolidated_Expense_History_20250622.csv,2025-07-18T12:32:53.413399,3.0,advanced_calculations_v3,exp_v3_001417,2024.00,7.00,3.00,False,False,False,True,40
Jordyn,2024-07-28,Wells Fargo Active Cash Visa Signature,UBER TRIP HELP.UBER.COM CA,Uber Ride Service,9.97,9.97,,Transportation,1874.54,9.97,9.97,0.00,simple,False,,expense_history_csv,Consolidated_Expense_History_20250622.csv,2025-07-18T12:32:53.413399,3.0,advanced_calculations_v3,exp_v3_001418,2024.00,7.00,3.00,False,False,False,True,40
Jordyn,2024-07-28,Wells Fargo Active Cash Visa Signature,SWA*UPGBOARD5264249060334800-435-9792 TX,Southwest Airlines Upgrade,80.00,80.00,,Travel,1954.54,80.00,80.00,0.00,simple,False,,expense_history_csv,Consolidated_Expense_History_20250622.csv,2025-07-18T12:32:53.413399,3.0,advanced_calculations_v3,exp_v3_001419,2024.00,7.00,3.00,False,False,False,True,40
Jordyn,2024-07-28,Wells Fargo Active Cash Visa Signature,SOUTHWESTAIR INFLIGHT DALLAS TX,Southwest Airlines,8.00,8.00,,Travel,1962.54,8.00,8.00,0.00,simple,False,,expense_history_csv,Consolidated_Expense_History_20250622.csv,2025-07-18T12:32:53.413399,3.0,advanced_calculations_v3,exp_v3_001420,2024.00,7.00,3.00,False,False,False,True,40
Jordyn,2024-07-28,Wells Fargo Active Cash Visa Signature,CULVERS OF CHANDLER CHANDLER AZ,Culver's,21.80,21.80,,Dining,1984.34,21.80,21.80,0.00,simple,False,,expense_history_csv,Consolidated_Expense_History_20250622.csv,2025-07-18T12:32:53.413399,3.0,advanced_calculations_v3,exp_v3_001421,2024.00,7.00,3.00,False,False,False,True,40
Jordyn,2024-07-28,Wells Fargo Active Cash Visa Signature,HILTON HOTELS MILWAUKEE WI,Hilton Hotels,76.00,76.00,,Travel,2060.34,76.00,76.00,0.00,simple,False,,expense_history_csv,Consolidated_Expense_History_20250622.csv,2025-07-18T12:32:53.413399,3.0,advanced_calculations_v3,exp_v3_001422,2024.00,7.00,3.00,False,False,False,True,40
Jordyn,2024-07-29,Wells Fargo Active Cash Visa Signature,FRONTLINE FOOD SERVIC PHOENIX AZ,Frontline Food Service,4.70,4.70,,Dining,2065.04,4.70,4.70,0.00,simple,False,,expense_history_csv,Consolidated_Expense_History_20250622.csv,2025-07-18T12:32:53.413399,3.0,advanced_calculations_v3,exp_v3_001423,2024.00,7.00,3.00,False,False,False,True,40
Jordyn,2024-07-29,Wells Fargo Active Cash Visa Signature,FRONTLINE FOOD SERVIC PHOENIX AZ,Frontline Food Service,4.70,4.70,,Dining,2069.74,4.70,4.70,0.00,simple,False,,expense_history_csv,Consolidated_Expense_History_20250622.csv,2025-07-18T12:32:53.413399,3.0,advanced_calculations_v3,exp_v3_001424,2024.00,7.00,3.00,False,False,False,True,40
Jordyn,2024-07-29,Wells Fargo Active Cash Visa Signature,FRONTLINE FOOD SERVIC,FRONTLINE FOOD SERVIC PHOENIX AZ,4.70,4.70,Food service,Dining,2074.44,4.70,4.70,0.00,simple,False,,expense_history_csv,Consolidated_Expense_History_20250622.csv,2025-07-18T12:32:53.413399,3.0,advanced_calculations_v3,exp_v3_001425,2024.00,7.00,3.00,False,False,False,True,60
Jordyn,2024-07-30,Wells Fargo Active Cash Visa Signature,AMAZON RETA* RV99E2V01 WWW.AMAZON.CO WA,Amazon,18.33,18.33,,Online Shopping,2092.77,18.33,18.33,0.00,simple,False,,expense_history_csv,Consolidated_Expense_History_20250622.csv,2025-07-18T12:32:53.413399,3.0,advanced_calculations_v3,exp_v3_001426,2024.00,7.00,3.00,False,False,False,True,40
Jordyn,2024-07-30,Wells Fargo Active Cash Visa Signature,AMAZON,AMAZON RETA* RV99E2V01 WWW.AMAZON.CO WA,18.33,18.33,Online purchase,Online Shopping,2111.10,18.33,18.33,0.00,simple,False,,expense_history_csv,Consolidated_Expense_History_20250622.csv,2025-07-18T12:32:53.413399,3.0,advanced_calculations_v3,exp_v3_001427,2024.00,7.00,3.00,False,False,False,True,60
Jordyn,2024-07-31,Wells Fargo Active Cash Visa Signature,SPROUTS FARMERS MAR CHANDLER AZ,Sprouts Farmers Market,38.27,38.27,,Groceries,2149.37,38.27,38.27,0.00,simple,False,,expense_history_csv,Consolidated_Expense_History_20250622.csv,2025-07-18T12:32:53.413399,3.0,advanced_calculations_v3,exp_v3_001428,2024.00,7.00,3.00,False,False,False,True,40
Jordyn,2024-07-31,Wells Fargo Active Cash Visa Signature,SPROUTS FARMERS MAR,SPROUTS FARMERS MAR CHANDLER AZ,38.27,38.27,Grocery purchase,Groceries,2187.64,38.27,38.27,0.00,simple,False,,expense_history_csv,Consolidated_Expense_History_20250622.csv,2025-07-18T12:32:53.413399,3.0,advanced_calculations_v3,exp_v3_001429,2024.00,7.00,3.00,False,False,False,True,60
Jordyn,2024-08-01,Wells Fargo Active Cash Visa Signature,AMAZON RETA* RV7ZW3YQ0 WWW.AMAZON.CO WA,Amazon,8.88,8.88,,Online Shopping,2196.52,8.88,8.88,0.00,simple,False,,expense_history_csv,Consolidated_Expense_History_20250622.csv,2025-07-18T12:32:53.413399,3.0,advanced_calculations_v3,exp_v3_001430,2024.00,8.00,3.00,False,False,False,True,40
Jordyn,2024-08-01,Wells Fargo Active Cash Visa Signature,AMAZON,AMAZON RETA* RV7ZW3YQ0 WWW.AMAZON.CO WA,8.88,8.88,Online purchase,Online Shopping,2205.40,8.88,8.88,0.00,simple,False,,expense_history_csv,Consolidated_Expense_History_20250622.csv,2025-07-18T12:32:53.413399,3.0,advanced_calculations_v3,exp_v3_001431,2024.00,8.00,3.00,False,False,False,True,60
Jordyn,2024-08-02,Wells Fargo Active Cash Visa Signature,Amazon.com*RV8N53YJ1 Amzn.com/bill WA,Amazon,5.34,5.34,,Online Shopping,2210.74,5.34,5.34,0.00,simple,False,,expense_history_csv,Consolidated_Expense_History_20250622.csv,2025-07-18T12:32:53.413399,3.0,advanced_calculations_v3,exp_v3_001432,2024.00,8.00,3.00,False,False,False,True,40
Jordyn,2024-08-02,Wells Fargo Active Cash Visa Signature,AMAZON MKTPL*RF3027Z70 Amzn.com/bill WA,Amazon Marketplace,10.77,10.77,,Online Shopping,2221.51,10.77,10.77,0.00,simple,False,,expense_history_csv,Consolidated_Expense_History_20250622.csv,2025-07-18T12:32:53.413399,3.0,advanced_calculations_v3,exp_v3_001433,2024.00,8.00,3.00,False,False,False,True,40
Jordyn,2024-08-02,Wells Fargo Active Cash Visa Signature,SQ *SPOOKY'S SWIRLS CHANDLER AZ,Spooky's Swirls,33.49,33.49,,Dining,2255.00,33.49,33.49,0.00,simple,False,,expense_history_csv,Consolidated_Expense_History_20250622.csv,2025-07-18T12:32:53.413399,3.0,advanced_calculations_v3,exp_v3_001434,2024.00,8.00,3.00,False,False,False,True,40
Jordyn,2024-08-02,Wells Fargo Active Cash Visa Signature,AMAZON,Amazon.com*RV8N53YJ1 Amzn.com/bill WA,5.34,5.34,Online purchase,Online Shopping,2260.34,5.34,5.34,0.00,simple,False,,expense_history_csv,Consolidated_Expense_History_20250622.csv,2025-07-18T12:32:53.413399,3.0,advanced_calculations_v3,exp_v3_001435,2024.00,8.00,3.00,False,False,False,True,60
Jordyn,2024-08-02,Wells Fargo Active Cash Visa Signature,AMAZON MARKETPLACE,AMAZON MKTPL*RF3027Z70 Amzn.com/bill WA,10.77,10.77,Online purchase,Online Shopping,2271.11,10.77,10.77,0.00,simple,False,,expense_history_csv,Consolidated_Expense_History_20250622.csv,2025-07-18T12:32:53.413399,3.0,advanced_calculations_v3,exp_v3_001436,2024.00,8.00,3.00,False,False,False,True,60
Jordyn,2024-08-02,Wells Fargo Active Cash Visa Signature,SPOOKY'S SWIRLS,SQ *SPOOKY'S SWIRLS CHANDLER AZ,33.49,33.49,Bakery purchase,Dining,2304.60,33.49,33.49,0.00,simple,False,,expense_history_csv,Consolidated_Expense_History_20250622.csv,2025-07-18T12:32:53.413399,3.0,advanced_calculations_v3,exp_v3_001437,2024.00,8.00,3.00,False,False,False,True,60
Jordyn,2024-08-03,Wells Fargo Active Cash Visa Signature,WALGREENS #3727 CHANDLER AZ,Walgreens,10.55,10.55,,Shopping,2315.15,10.55,10.55,0.00,simple,False,,expense_history_csv,Consolidated_Expense_History_20250622.csv,2025-07-18T12:32:53.413399,3.0,advanced_calculations_v3,exp_v3_001438,2024.00,8.00,3.00,False,False,False,True,40
Jordyn,2024-08-03,Wells Fargo Active Cash Visa Signature,WALGREENS,WALGREENS #3727 CHANDLER AZ,10.55,10.55,Drugstore purchase,Shopping,2325.70,10.55,10.55,0.00,simple,False,,expense_history_csv,Consolidated_Expense_History_20250622.csv,2025-07-18T12:32:53.413399,3.0,advanced_calculations_v3,exp_v3_001439,2024.00,8.00,3.00,False,False,False,True,60
Jordyn,2024-08-05,Wells Fargo Active Cash Visa Signature,FRYS-FOOD-DRG #051 CHANDLER AZ,Fry's Food and Drug,94.29,94.29,,Groceries,2419.99,94.29,94.29,0.00,simple,False,,expense_history_csv,Consolidated_Expense_History_20250622.csv,2025-07-18T12:32:53.413399,3.0,advanced_calculations_v3,exp_v3_001440,2024.00,8.00,3.00,False,False,False,True,40
Jordyn,2024-08-06,Wells Fargo Active Cash Visa Signature,FRYS-FOOD-DRG #051 CHANDLER AZ,Fry's Food and Drug,7.86,7.86,,Groceries,2427.85,7.86,7.86,0.00,simple,False,,expense_history_csv,Consolidated_Expense_History_20250622.csv,2025-07-18T12:32:53.413399,3.0,advanced_calculations_v3,exp_v3_001441,2024.00,8.00,3.00,False,False,False,True,40
Jordyn,2024-08-08,Wells Fargo Active Cash Visa Signature,CASH BACK REDEMPTION REF 154113882,Wells Fargo Cash Back,-51.83,-51.83,,Rewards,2376.02,-51.83,-51.83,0.00,simple,False,,expense_history_csv,Consolidated_Expense_History_20250622.csv,2025-07-18T12:32:53.413399,3.0,advanced_calculations_v3,exp_v3_001442,2024.00,8.00,3.00,False,False,False,True,40
Jordyn,2024-08-11,Wells Fargo Active Cash Visa Signature,FRYS 5051 866-576-4377 AZ,Fry's,194.88,194.88,,Groceries,2570.90,194.88,194.88,0.00,simple,False,,expense_history_csv,Consolidated_Expense_History_20250622.csv,2025-07-18T12:32:53.413399,3.0,advanced_calculations_v3,exp_v3_001443,2024.00,8.00,3.00,False,False,False,True,40
Jordyn,2024-08-12,Wells Fargo Active Cash Visa Signature,AUTOMATIC PAYMENT - THANK YOU,Wells Fargo Payment,-57.00,-57.00,,Payment,2513.90,-57.00,-57.00,0.00,simple,False,,expense_history_csv,Consolidated_Expense_History_20250622.csv,2025-07-18T12:32:53.413399,3.0,advanced_calculations_v3,exp_v3_001444,2024.00,8.00,3.00,False,False,False,True,40
Jordyn,2024-08-13,Wells Fargo Active Cash Visa Signature,SPROUTS FARMERS MAR CHANDLER AZ,Sprouts Farmers Market,31.71,31.71,,Groceries,2545.61,31.71,31.71,0.00,simple,False,,expense_history_csv,Consolidated_Expense_History_20250622.csv,2025-07-18T12:32:53.413399,3.0,advanced_calculations_v3,exp_v3_001445,2024.00,8.00,3.00,False,False,False,True,40
Jordyn,2024-08-13,Wells Fargo Active Cash Visa Signature,WALGREENS #2056 CHANDLER AZ,Walgreens,15.68,15.68,,Shopping,2561.29,15.68,15.68,0.00,simple,False,,expense_history_csv,Consolidated_Expense_History_20250622.csv,2025-07-18T12:32:53.413399,3.0,advanced_calculations_v3,exp_v3_001446,2024.00,8.00,3.00,False,False,False,True,40
Jordyn,2024-08-14,Wells Fargo Active Cash Visa Signature,FRYS FUEL #7658 GILBERT AZ,Fry's Fuel,25.77,25.77,,Transportation,2587.06,25.77,25.77,0.00,simple,False,,expense_history_csv,Consolidated_Expense_History_20250622.csv,2025-07-18T12:32:53.413399,3.0,advanced_calculations_v3,exp_v3_001447,2024.00,8.00,3.00,False,False,False,True,40
Jordyn,2024-08-18,Wells Fargo Active Cash Visa Signature,TST* O.H.S.O. - GILBERT GILBERT AZ,O.H.S.O. Restaurant,84.35,84.35,,Dining,2671.41,84.35,84.35,0.00,simple,False,,expense_history_csv,Consolidated_Expense_History_20250622.csv,2025-07-18T12:32:53.413399,3.0,advanced_calculations_v3,exp_v3_001448,2024.00,8.00,3.00,False,False,False,True,40
Jordyn,2024-08-18,Wells Fargo Active Cash Visa Signature,Amazon.com*RU22U1VB0 Amzn.com/bill WA,Amazon,21.88,21.88,,Online Shopping,2693.29,21.88,21.88,0.00,simple,False,,expense_history_csv,Consolidated_Expense_History_20250622.csv,2025-07-18T12:32:53.413399,3.0,advanced_calculations_v3,exp_v3_001449,2024.00,8.00,3.00,False,False,False,True,40
Jordyn,2024-08-19,Wells Fargo Active Cash Visa Signature,SPROUTS FARMERS MAR CHANDLER AZ,Sprouts Farmers Market,100.00,100.00,,Groceries,2793.29,100.00,100.00,0.00,simple,False,,expense_history_csv,Consolidated_Expense_History_20250622.csv,2025-07-18T12:32:53.413399,3.0,advanced_calculations_v3,exp_v3_001450,2024.00,8.00,3.00,False,False,False,True,40
Jordyn,2024-08-19,Wells Fargo Active Cash Visa Signature,AMAZON MKTPL*RU4YW4QX1 Amzn.com/bill WA,Amazon Marketplace,19.13,19.13,,Online Shopping,2812.42,19.13,19.13,0.00,simple,False,,expense_history_csv,Consolidated_Expense_History_20250622.csv,2025-07-18T12:32:53.413399,3.0,advanced_calculations_v3,exp_v3_001451,2024.00,8.00,3.00,False,False,False,True,40
Jordyn,2024-08-19,Wells Fargo Active Cash Visa Signature,AMAZON MKTPL*R44BU0ZG2 Amzn.com/bill WA,Amazon Marketplace,15.21,15.21,,Online Shopping,2827.63,15.21,15.21,0.00,simple,False,,expense_history_csv,Consolidated_Expense_History_20250622.csv,2025-07-18T12:32:53.413399,3.0,advanced_calculations_v3,exp_v3_001452,2024.00,8.00,3.00,False,False,False,True,40
Jordyn,2024-08-22,Wells Fargo Active Cash Visa Signature,SAFEWAY #1535 TEMPE AZ,Safeway,31.36,31.36,,Groceries,2858.99,31.36,31.36,0.00,simple,False,,expense_history_csv,Consolidated_Expense_History_20250622.csv,2025-07-18T12:32:53.413399,3.0,advanced_calculations_v3,exp_v3_001453,2024.00,8.00,3.00,False,False,False,True,40
Jordyn,2024-08-22,Wells Fargo Active Cash Visa Signature,FRYS 5627 866-576-4377 AZ,Fry's,37.11,37.11,,Groceries,2896.10,37.11,37.11,0.00,simple,False,,expense_history_csv,Consolidated_Expense_History_20250622.csv,2025-07-18T12:32:53.413399,3.0,advanced_calculations_v3,exp_v3_001454,2024.00,8.00,3.00,False,False,False,True,40
Jordyn,2024-08-22,Wells Fargo Active Cash Visa Signature,AMAZON MKTPL*R49DK8F80 Amzn.com/bill WA,Amazon Marketplace,12.88,12.88,,Online Shopping,2908.98,12.88,12.88,0.00,simple,False,,expense_history_csv,Consolidated_Expense_History_20250622.csv,2025-07-18T12:32:53.413399,3.0,advanced_calculations_v3,exp_v3_001455,2024.00,8.00,3.00,False,False,False,True,40
Jordyn,2024-08-23,Wells Fargo Active Cash Visa Signature,FRYS-FOOD-DRG #051 CHANDLER AZ,Fry's Food and Drug,45.57,45.57,,Groceries,2954.55,45.57,45.57,0.00,simple,False,,expense_history_csv,Consolidated_Expense_History_20250622.csv,2025-07-18T12:32:53.413399,3.0,advanced_calculations_v3,exp_v3_001456,2024.00,8.00,3.00,False,False,False,True,40
Jordyn,2024-08-26,Wells Fargo Active Cash Visa Signature,FRYS 5051 866-576-4377 AZ,Fry's,214.62,214.62,,Groceries,3169.17,214.62,214.62,0.00,simple,False,,expense_history_csv,Consolidated_Expense_History_20250622.csv,2025-07-18T12:32:53.413399,3.0,advanced_calculations_v3,exp_v3_001457,2024.00,8.00,3.00,False,False,False,True,40
Jordyn,2024-08-26,Wells Fargo Active Cash Visa Signature,AMAZON MKTPL*R42S59DR1 Amzn.com/bill WA,Amazon Marketplace,20.47,20.47,,Online Shopping,3189.64,20.47,20.47,0.00,simple,False,,expense_history_csv,Consolidated_Expense_History_20250622.csv,2025-07-18T12:32:53.413399,3.0,advanced_calculations_v3,exp_v3_001458,2024.00,8.00,3.00,False,False,False,True,40
Jordyn,2024-08-27,Wells Fargo Active Cash Visa Signature,AMAZON RETA* RK2N871X2 WWW.AMAZON.CO WA,Amazon,40.64,40.64,,Online Shopping,3230.28,40.64,40.64,0.00,simple,False,,expense_history_csv,Consolidated_Expense_History_20250622.csv,2025-07-18T12:32:53.413399,3.0,advanced_calculations_v3,exp_v3_001459,2024.00,8.00,3.00,False,False,False,True,40
Jordyn,2024-08-27,Wells Fargo Active Cash Visa Signature,FRYS #658 GILBERT AZ,Fry's,34.24,34.24,,Groceries,3264.52,34.24,34.24,0.00,simple,False,,expense_history_csv,Consolidated_Expense_History_20250622.csv,2025-07-18T12:32:53.413399,3.0,advanced_calculations_v3,exp_v3_001460,2024.00,8.00,3.00,False,False,False,True,40
Jordyn,2024-08-28,Wells Fargo Active Cash Visa Signature,AMAZON RETA* RK8XL5512 WWW.AMAZON.CO WA,Amazon,8.61,8.61,,Online Shopping,3273.13,8.61,8.61,0.00,simple,False,,expense_history_csv,Consolidated_Expense_History_20250622.csv,2025-07-18T12:32:53.413399,3.0,advanced_calculations_v3,exp_v3_001461,2024.00,8.00,3.00,False,False,False,True,40
Jordyn,2024-08-30,Wells Fargo Active Cash Visa Signature,WELLGROOMEDPETS.COM 148-08082002 AZ,Wellgroomed Pets,108.10,108.10,,Pets,3381.23,108.10,108.10,0.00,simple,False,,expense_history_csv,Consolidated_Expense_History_20250622.csv,2025-07-18T12:32:53.413399,3.0,advanced_calculations_v3,exp_v3_001462,2024.00,8.00,3.00,False,False,False,True,40
Jordyn,2024-08-30,Wells Fargo Active Cash Visa Signature,PETS BEST INSURANCE SERV 877-738-7237 NC,Pets Best Insurance,62.31,62.31,,Pets,3443.54,62.31,62.31,0.00,simple,False,,expense_history_csv,Consolidated_Expense_History_20250622.csv,2025-07-18T12:32:53.413399,3.0,advanced_calculations_v3,exp_v3_001463,2024.00,8.00,3.00,False,False,False,True,40
Jordyn,2024-08-30,Wells Fargo Active Cash Visa Signature,TM *DILLON FRANCIS 800-653-8000 CA,Ticketmaster,196.18,196.18,,Entertainment,3639.72,196.18,196.18,0.00,simple,False,,expense_history_csv,Consolidated_Expense_History_20250622.csv,2025-07-18T12:32:53.413399,3.0,advanced_calculations_v3,exp_v3_001464,2024.00,8.00,3.00,False,False,False,True,40
Jordyn,2024-08-31,Wells Fargo Active Cash Visa Signature,EXXON LAKE JENNINGS GAS EL CAJON CA,Exxon,5.64,5.64,,Transportation,3645.36,5.64,5.64,0.00,simple,False,,expense_history_csv,Consolidated_Expense_History_20250622.csv,2025-07-18T12:32:53.413399,3.0,advanced_calculations_v3,exp_v3_001465,2024.00,8.00,3.00,False,False,False,True,40
Jordyn,2024-08-31,Wells Fargo Active Cash Visa Signature,SHELL OIL 57442518304 GILA BEND AZ,Shell,7.23,7.23,,Transportation,3652.59,7.23,7.23,0.00,simple,False,,expense_history_csv,Consolidated_Expense_History_20250622.csv,2025-07-18T12:32:53.413399,3.0,advanced_calculations_v3,exp_v3_001466,2024.00,8.00,3.00,False,False,False,True,40
Jordyn,2024-08-31,Wells Fargo Active Cash Visa Signature,CIRCLE K 09183 CHANDLER AZ,Circle K,30.05,30.05,,Transportation,3682.64,30.05,30.05,0.00,simple,False,,expense_history_csv,Consolidated_Expense_History_20250622.csv,2025-07-18T12:32:53.413399,3.0,advanced_calculations_v3,exp_v3_001467,2024.00,8.00,3.00,False,False,False,True,40
Jordyn,2024-09-01,Wells Fargo Active Cash Visa Signature,OB QUICK STOP SAN DIEGO CA,OB Quick Stop,7.05,7.05,,Shopping,3689.69,7.05,7.05,0.00,simple,False,,expense_history_csv,Consolidated_Expense_History_20250622.csv,2025-07-18T12:32:53.413399,3.0,advanced_calculations_v3,exp_v3_001468,2024.00,9.00,3.00,False,False,False,True,40
Jordyn,2024-09-01,Wells Fargo Active Cash Visa Signature,CHEVRON 0352705 DATELAND AZ,Chevron,13.98,13.98,,Transportation,3703.67,13.98,13.98,0.00,simple,False,,expense_history_csv,Consolidated_Expense_History_20250622.csv,2025-07-18T12:32:53.413399,3.0,advanced_calculations_v3,exp_v3_001469,2024.00,9.00,3.00,False,False,False,True,40
Jordyn,2024-09-01,Wells Fargo Active Cash Visa Signature,TST*LUCYS TAVERN San Diego CA,Lucy's Tavern,10.80,10.80,,Dining,3714.47,10.80,10.80,0.00,simple,False,,expense_history_csv,Consolidated_Expense_History_20250622.csv,2025-07-18T12:32:53.413399,3.0,advanced_calculations_v3,exp_v3_001470,2024.00,9.00,3.00,False,False,False,True,40
Jordyn,2024-09-01,Wells Fargo Active Cash Visa Signature,CSD 6TH & K PARK 39888 SAN DIEGO CA,CSD 6th & K Park,25.00,25.00,,Transportation,3739.47,25.00,25.00,0.00,simple,False,,expense_history_csv,Consolidated_Expense_History_20250622.csv,2025-07-18T12:32:53.413399,3.0,advanced_calculations_v3,exp_v3_001471,2024.00,9.00,3.00,False,False,False,True,40
Jordyn,2024-09-02,Wells Fargo Active Cash Visa Signature,SHELL OIL 10006123003 SAN DIEGO CA,Shell,9.37,9.37,,Transportation,3748.84,9.37,9.37,0.00,simple,False,,expense_history_csv,Consolidated_Expense_History_20250622.csv,2025-07-18T12:32:53.413399,3.0,advanced_calculations_v3,exp_v3_001472,2024.00,9.00,3.00,False,False,False,True,40
Jordyn,2024-09-02,Wells Fargo Active Cash Visa Signature,UBER *TRIP HELP.UBER.COM CA,Uber Ride Service,35.96,35.96,,Transportation,3784.80,35.96,35.96,0.00,simple,False,,expense_history_csv,Consolidated_Expense_History_20250622.csv,2025-07-18T12:32:53.413399,3.0,advanced_calculations_v3,exp_v3_001473,2024.00,9.00,3.00,False,False,False,True,40
Jordyn,2024-09-02,Wells Fargo Active Cash Visa Signature,UBER *TRIP HELP.UBER.COM CA,Uber Ride Service,20.00,20.00,,Transportation,3804.80,20.00,20.00,0.00,simple,False,,expense_history_csv,Consolidated_Expense_History_20250622.csv,2025-07-18T12:32:53.413399,3.0,advanced_calculations_v3,exp_v3_001474,2024.00,9.00,3.00,False,False,False,True,40
Jordyn,2024-09-02,Wells Fargo Active Cash Visa Signature,GRAND HYATT SAN DIEGO FB SAN DIEGO CA,Grand Hyatt,149.07,149.07,,Travel,3953.87,149.07,149.07,0.00,simple,False,,expense_history_csv,Consolidated_Expense_History_20250622.csv,2025-07-18T12:32:53.413399,3.0,advanced_calculations_v3,exp_v3_001475,2024.00,9.00,3.00,False,False,False,True,40
Jordyn,2024-09-04,Wells Fargo Active Cash Visa Signature,AKCHIN PAVILION AMPHI PHOENIX AZ,Ak-Chin Pavilion,39.01,39.01,,Entertainment,3992.88,39.01,39.01,0.00,simple,False,,expense_history_csv,Consolidated_Expense_History_20250622.csv,2025-07-18T12:32:53.413399,3.0,advanced_calculations_v3,exp_v3_001476,2024.00,9.00,3.00,False,False,False,True,40
Jordyn,2024-09-05,Wells Fargo Active Cash Visa Signature,TARGET 00018382 CHANDLER AZ,Target,16.78,16.78,,Shopping,4009.66,16.78,16.78,0.00,simple,False,,expense_history_csv,Consolidated_Expense_History_20250622.csv,2025-07-18T12:32:53.413399,3.0,advanced_calculations_v3,exp_v3_001477,2024.00,9.00,3.00,False,False,False,True,40
Jordyn,2024-09-05,Wells Fargo Active Cash Visa Signature,UBER *TRIP HELP.UBER.COM CA,Uber Ride Service,41.15,41.15,,Transportation,4050.81,41.15,41.15,0.00,simple,False,,expense_history_csv,Consolidated_Expense_History_20250622.csv,2025-07-18T12:32:53.413399,3.0,advanced_calculations_v3,exp_v3_001478,2024.00,9.00,3.00,False,False,False,True,40
Jordyn,2024-09-06,Wells Fargo Active Cash Visa Signature,QT 478 MESA AZ,QT,9.97,9.97,,Transportation,4060.78,9.97,9.97,0.00,simple,False,,expense_history_csv,Consolidated_Expense_History_20250622.csv,2025-07-18T12:32:53.413399,3.0,advanced_calculations_v3,exp_v3_001479,2024.00,9.00,3.00,False,False,False,True,40
Jordyn,2024-09-07,Wells Fargo Active Cash Visa Signature,SCOTTSDALE ARTS 480-9942787 AZ,Scottsdale Arts,20.00,20.00,,Entertainment,4080.78,20.00,20.00,0.00,simple,False,,expense_history_csv,Consolidated_Expense_History_20250622.csv,2025-07-18T12:32:53.413399,3.0,advanced_calculations_v3,exp_v3_001480,2024.00,9.00,3.00,False,False,False,True,40
Jordyn,2024-09-08,Wells Fargo Active Cash Visa Signature,FRYS 5051 866-576-4377 AZ,Fry's,297.75,297.75,,Groceries,4378.53,297.75,297.75,0.00,simple,False,,expense_history_csv,Consolidated_Expense_History_20250622.csv,2025-07-18T12:32:53.413399,3.0,advanced_calculations_v3,exp_v3_001481,2024.00,9.00,3.00,False,False,False,True,40
Jordyn,2024-09-08,Wells Fargo Active Cash Visa Signature,AMAZON MKTPL*ZT8AP12A1 Amzn.com/bill WA,Amazon Marketplace,22.41,22.41,,Online Shopping,4400.94,22.41,22.41,0.00,simple,False,,expense_history_csv,Consolidated_Expense_History_20250622.csv,2025-07-18T12:32:53.413399,3.0,advanced_calculations_v3,exp_v3_001482,2024.00,9.00,3.00,False,False,False,True,40
Jordyn,2024-09-12,Wells Fargo Active Cash Visa Signature,AUTOMATIC PAYMENT - THANK YOU,Wells Fargo Payment,-117.00,-117.00,,Payment,4283.94,-117.00,-117.00,0.00,simple,False,,expense_history_csv,Consolidated_Expense_History_20250622.csv,2025-07-18T12:32:53.413399,3.0,advanced_calculations_v3,exp_v3_001483,2024.00,9.00,3.00,False,False,False,True,40
Jordyn,2024-09-13,Wells Fargo Active Cash Visa Signature,SPROUTS FARMERS MAR CHANDLER AZ,Sprouts Farmers Market,63.19,63.19,,Groceries,4347.13,63.19,63.19,0.00,simple,False,,expense_history_csv,Consolidated_Expense_History_20250622.csv,2025-07-18T12:32:53.413399,3.0,advanced_calculations_v3,exp_v3_001484,2024.00,9.00,3.00,False,False,False,True,40
Jordyn,2024-09-15,Wells Fargo Active Cash Visa Signature,TARGET 00018382 CHANDLER AZ,Target,48.90,48.90,,Shopping,4396.03,48.90,48.90,0.00,simple,False,,expense_history_csv,Consolidated_Expense_History_20250622.csv,2025-07-18T12:32:53.413399,3.0,advanced_calculations_v3,exp_v3_001485,2024.00,9.00,3.00,False,False,False,True,40
Jordyn,2024-09-15,Wells Fargo Active Cash Visa Signature,IN-N-OUT CHANDLER 2 CHANDLER AZ,In-N-Out,13.89,13.89,,Dining,4409.92,13.89,13.89,0.00,simple,False,,expense_history_csv,Consolidated_Expense_History_20250622.csv,2025-07-18T12:32:53.413399,3.0,advanced_calculations_v3,exp_v3_001486,2024.00,9.00,3.00,False,False,False,True,40
Jordyn,2024-09-16,Wells Fargo Active Cash Visa Signature,PETSMART # 1017 CHANDLER AZ,Petsmart,169.19,169.19,,Pets,4579.11,169.19,169.19,0.00,simple,False,,expense_history_csv,Consolidated_Expense_History_20250622.csv,2025-07-18T12:32:53.413399,3.0,advanced_calculations_v3,exp_v3_001487,2024.00,9.00,3.00,False,False,False,True,40
Jordyn,2024-09-16,Wells Fargo Active Cash Visa Signature,FRYS-FOOD-DRG #051 CHANDLER AZ,Fry's Food and Drug,40.39,40.39,,Groceries,4619.50,40.39,40.39,0.00,simple,False,,expense_history_csv,Consolidated_Expense_History_20250622.csv,2025-07-18T12:32:53.413399,3.0,advanced_calculations_v3,exp_v3_001488,2024.00,9.00,3.00,False,False,False,True,40
Jordyn,2024-09-15,Wells Fargo Autograph Visa ****5037,IN-N-OUT CHANDLER 2 CHANDLER AZ#2469216LL305DERQ9,In-N-Out,13.89,13.89,,Dining & Drinks,4633.39,13.89,13.89,0.00,simple,False,,expense_history_csv,Consolidated_Expense_History_20250622.csv,2025-07-18T12:32:53.413399,3.0,advanced_calculations_v3,exp_v3_001489,2024.00,9.00,3.00,False,False,False,True,40
Jordyn,2024-09-15,Wells Fargo Autograph Visa ****5037,TARGET 00018382 CHANDLER AZ#2416407LK2LR7H613,Target,48.90,48.90,,Shopping,4682.29,48.90,48.90,0.00,simple,False,,expense_history_csv,Consolidated_Expense_History_20250622.csv,2025-07-18T12:32:53.413399,3.0,advanced_calculations_v3,exp_v3_001490,2024.00,9.00,3.00,False,False,False,True,40
Jordyn,2024-09-15,Wells Fargo Autograph Visa ****5037,TARGET 00018382 CHANDLER AZ#2416407LK2LR7H613,Target,48.90,48.90,Shopping,$492.05,4731.19,48.90,48.90,0.00,simple,False,,expense_history_csv,Consolidated_Expense_History_20250622.csv,2025-07-18T12:32:53.413399,3.0,advanced_calculations_v3,exp_v3_001491,2024.00,9.00,3.00,False,False,False,True,60
Jordyn,2024-09-16,Wells Fargo Autograph Visa ****5037,FRYS-FOOD-DRG #051 CHANDLER AZ#2444500LL8PNZN3AS,Fry's Food and Drug,40.39,40.39,,Groceries,4771.58,40.39,40.39,0.00,simple,False,,expense_history_csv,Consolidated_Expense_History_20250622.csv,2025-07-18T12:32:53.413399,3.0,advanced_calculations_v3,exp_v3_001492,2024.00,9.00,3.00,False,False,False,True,40
Jordyn,2024-09-16,Wells Fargo Autograph Visa ****5037,PETSMART # 1017 CHANDLER AZ#2423168LM2M403GEF,Petsmart,169.19,169.19,,Pet Care,4940.77,169.19,169.19,0.00,simple,False,,expense_history_csv,Consolidated_Expense_History_20250622.csv,2025-07-18T12:32:53.413399,3.0,advanced_calculations_v3,exp_v3_001493,2024.00,9.00,3.00,False,False,False,True,40
Jordyn,2024-09-17,Wells Fargo Autograph Visa ****5037,INTEREST CHARGE ON PURCHASES,Interest Charge,108.20,108.20,,Finance Charge,5048.97,108.20,108.20,0.00,simple,False,,expense_history_csv,Consolidated_Expense_History_20250622.csv,2025-07-18T12:32:53.413399,3.0,advanced_calculations_v3,exp_v3_001494,2024.00,9.00,3.00,False,False,False,True,40
Jordyn,2024-09-18,Wells Fargo Autograph Visa ****5037,AMAZON MKTPL*YC0N479G3 Amzn.com/billWA#2469216LN31HJ5K77,Amazon,29.10,29.10,,Shopping,5078.07,29.10,29.10,0.00,simple,False,,expense_history_csv,Consolidated_Expense_History_20250622.csv,2025-07-18T12:32:53.413399,3.0,advanced_calculations_v3,exp_v3_001495,2024.00,9.00,3.00,False,False,False,True,40
Jordyn,2024-09-21,Wells Fargo Autograph Visa ****5037,PHO CHANDLER CHANDLER AZ#2476501LS2SQKKTXK,Pho Chandler,34.00,34.00,,Dining & Drinks,5112.07,34.00,34.00,0.00,simple,False,,expense_history_csv,Consolidated_Expense_History_20250622.csv,2025-07-18T12:32:53.413399,3.0,advanced_calculations_v3,exp_v3_001496,2024.00,9.00,3.00,False,False,False,True,40
Jordyn,2024-09-21,Wells Fargo Autograph Visa ****5037,TST*SNEAKY BIRD-COOLEY S 480-300-3315 AZ#2469216LT3428ME5E,Sneaky Bird,26.14,26.14,,Dining & Drinks,5138.21,26.14,26.14,0.00,simple,False,,expense_history_csv,Consolidated_Expense_History_20250622.csv,2025-07-18T12:32:53.413399,3.0,advanced_calculations_v3,exp_v3_001497,2024.00,9.00,3.00,False,False,False,True,40
Jordyn,2024-09-21,Wells Fargo Autograph Visa ****5037,TARGET 00018382 CHANDLER AZ#2416407LS2LR7BPG5,Target,5.39,5.39,,Shopping,5143.60,5.39,5.39,0.00,simple,False,,expense_history_csv,Consolidated_Expense_History_20250622.csv,2025-07-18T12:32:53.413399,3.0,advanced_calculations_v3,exp_v3_001498,2024.00,9.00,3.00,False,False,False,True,40
Jordyn,2024-09-21,Wells Fargo Autograph Visa ****5037,VCA ANIMAL HOSPITALS HTTPSVCAHOSPICA#2401134LT000LJKJF,VCA Animal Hospitals,540.05,540.05,,Pet Care,5683.65,540.05,540.05,0.00,simple,False,,expense_history_csv,Consolidated_Expense_History_20250622.csv,2025-07-18T12:32:53.413399,3.0,advanced_calculations_v3,exp_v3_001499,2024.00,9.00,3.00,False,False,False,True,40
Jordyn,2024-09-23,Wells Fargo Autograph Visa ****5037,StubHub Event Tickets Wilmington DE#2479338LV017V611B,StubHub,236.60,236.60,,Entertainment,5920.25,236.60,236.60,0.00,simple,False,,expense_history_csv,Consolidated_Expense_History_20250622.csv,2025-07-18T12:32:53.413399,3.0,advanced_calculations_v3,exp_v3_001500,2024.00,9.00,3.00,False,False,False,True,40
Jordyn,2024-09-24,Wells Fargo Autograph Visa ****5037,QT 478 MESA AZ#2469216LX2XVJJYH3,QT,2.99,2.99,,Auto & Transport,5923.24,2.99,2.99,0.00,simple,False,,expense_history_csv,Consolidated_Expense_History_20250622.csv,2025-07-18T12:32:53.413399,3.0,advanced_calculations_v3,exp_v3_001501,2024.00,9.00,3.00,False,False,False,True,40
Jordyn,2024-09-24,Wells Fargo Autograph Visa ****5037,FRYS-FOOD-DRG #051 CHANDLER AZ#2444500LW8PNLDR0Z,Fry's Food and Drug,42.34,42.34,,Groceries,5965.58,42.34,42.34,0.00,simple,False,,expense_history_csv,Consolidated_Expense_History_20250622.csv,2025-07-18T12:32:53.413399,3.0,advanced_calculations_v3,exp_v3_001502,2024.00,9.00,3.00,False,False,False,True,40
Jordyn,2024-09-25,Wells Fargo Autograph Visa ****5037,AMAZON MKTPL*BP2YO8963 Amzn.com/billWA#2469216LX2Y6L8HRX,Amazon,30.49,30.49,,Shopping,5996.07,30.49,30.49,0.00,simple,False,,expense_history_csv,Consolidated_Expense_History_20250622.csv,2025-07-18T12:32:53.413399,3.0,advanced_calculations_v3,exp_v3_001503,2024.00,9.00,3.00,False,False,False,True,40
Jordyn,2024-09-25,Wells Fargo Autograph Visa ****5037,AMAZON MKTPL*UW9ZK4473 Amzn.com/billWA#2469216LX2XSWQXTV,Amazon,26.94,26.94,,Shopping,6023.01,26.94,26.94,0.00,simple,False,,expense_history_csv,Consolidated_Expense_History_20250622.csv,2025-07-18T12:32:53.413399,3.0,advanced_calculations_v3,exp_v3_001504,2024.00,9.00,3.00,False,False,False,True,40
Jordyn,2024-09-25,Wells Fargo Autograph Visa ****5037,FRYS FUEL #7658 GILBERT AZ#2444500LX8PP1J4E9,Fry's Fuel,28.22,28.22,,Auto & Transport,6051.23,28.22,28.22,0.00,simple,False,,expense_history_csv,Consolidated_Expense_History_20250622.csv,2025-07-18T12:32:53.413399,3.0,advanced_calculations_v3,exp_v3_001505,2024.00,9.00,3.00,False,False,False,True,40
Jordyn,2024-09-25,Wells Fargo Autograph Visa ****5037,BOBBY Q MESA AZ#2405522LY2XPL80N4,Bobby Q,88.73,88.73,,Dining & Drinks,6139.96,88.73,88.73,0.00,simple,False,,expense_history_csv,Consolidated_Expense_History_20250622.csv,2025-07-18T12:32:53.413399,3.0,advanced_calculations_v3,exp_v3_001506,2024.00,9.00,3.00,False,False,False,True,40
Jordyn,2024-09-26,Wells Fargo Autograph Visa ****5037,SPROUTS FARMERS MAR CHANDLER AZ#2442733LZLM8MGS5J,Sprouts,43.60,43.60,,Groceries,6183.56,43.60,43.60,0.00,simple,False,,expense_history_csv,Consolidated_Expense_History_20250622.csv,2025-07-18T12:32:53.413399,3.0,advanced_calculations_v3,exp_v3_001507,2024.00,9.00,3.00,False,False,False,True,40
Jordyn,2024-09-27,Wells Fargo Autograph Visa ****5037,AMAZON MKTPL*6N2DS7LN3 Amzn.com/billWA#2469216LZ2ZNXKPLG,Amazon,29.09,29.09,,Shopping,6212.65,29.09,29.09,0.00,simple,False,,expense_history_csv,Consolidated_Expense_History_20250622.csv,2025-07-18T12:32:53.413399,3.0,advanced_calculations_v3,exp_v3_001508,2024.00,9.00,3.00,False,False,False,True,40
Jordyn,2024-09-28,Wells Fargo Autograph Visa ****5037,TARGET 00018382 CHANDLER AZ#7416407M12LRQ5S74,Target,,,,Refund,6212.65,,,0.00,simple,False,,expense_history_csv,Consolidated_Expense_History_20250622.csv,2025-07-18T12:32:53.413399,3.0,advanced_calculations_v3,exp_v3_001509,2024.00,9.00,3.00,False,False,False,False,-20
Jordyn,2024-07-20,Discover,Discover,Monthly payment,214.58,214.58,Monthly payment on loan,,6427.23,214.58,214.58,0.00,simple,False,,expense_history_csv,Consolidated_Expense_History_20250622.csv,2025-07-18T12:32:53.413399,3.0,advanced_calculations_v3,exp_v3_001510,2024.00,7.00,3.00,False,False,False,True,60
Jordyn,2024-08-20,Discover,Discover,Monthly payment,214.58,214.58,Monthly payment on loan,,6641.81,214.58,214.58,0.00,simple,False,,expense_history_csv,Consolidated_Expense_History_20250622.csv,2025-07-18T12:32:53.413399,3.0,advanced_calculations_v3,exp_v3_001511,2024.00,8.00,3.00,False,False,False,True,60
Jordyn,2024-09-20,Discover,Discover,Monthly payment,214.58,214.58,Monthly payment on loan,,6856.39,214.58,214.58,0.00,simple,False,,expense_history_csv,Consolidated_Expense_History_20250622.csv,2025-07-18T12:32:53.413399,3.0,advanced_calculations_v3,exp_v3_001512,2024.00,9.00,3.00,False,False,False,True,60
Jordyn,2024-09-18,Chase Zelle to Ryan,Chase Zelle,Transfer,300.00,300.00,Payment to Ryan,,7156.39,300.00,300.00,0.00,simple,False,,expense_history_csv,Consolidated_Expense_History_20250622.csv,2025-07-18T12:32:53.413399,3.0,advanced_calculations_v3,exp_v3_001513,2024.00,9.00,3.00,False,False,False,True,60
Jordyn,2024-09-17,Chase Zelle to Ryan,Chase Zelle,Transfer,500.00,500.00,Payment to Ryan,,7656.39,500.00,500.00,0.00,simple,False,,expense_history_csv,Consolidated_Expense_History_20250622.csv,2025-07-18T12:32:53.413399,3.0,advanced_calculations_v3,exp_v3_001514,2024.00,9.00,3.00,False,False,False,True,60
Jordyn,2024-09-09,Chase Zelle to Ryan,Chase Zelle,Transfer,1000.00,1000.00,Payment to Ryan,,8656.39,1000.00,1000.00,0.00,simple,False,,expense_history_csv,Consolidated_Expense_History_20250622.csv,2025-07-18T12:32:53.413399,3.0,advanced_calculations_v3,exp_v3_001515,2024.00,9.00,3.00,False,False,False,True,60
Jordyn,2024-08-02,Chase Zelle to Ryan,Chase Zelle,Transfer,3000.00,3000.00,Payment to Ryan,,11656.39,3000.00,3000.00,0.00,simple,False,,expense_history_csv,Consolidated_Expense_History_20250622.csv,2025-07-18T12:32:53.413399,3.0,advanced_calculations_v3,exp_v3_001516,2024.00,8.00,3.00,False,False,False,True,60
Jordyn,2024-07-26,Chase Zelle to Ryan,Chase Zelle,Transfer,200.00,200.00,Payment to Ryan,,11856.39,200.00,200.00,0.00,simple,False,,expense_history_csv,Consolidated_Expense_History_20250622.csv,2025-07-18T12:32:53.413399,3.0,advanced_calculations_v3,exp_v3_001517,2024.00,7.00,3.00,False,False,False,True,60
